"date","Hospital_Intake_Proven","Hospital_Intake_Suspected","IC_Intake_Proven","IC_Intake_Suspected","IC_Current","ICs_Used","IC_Cumulative","Hospital_Currently","IC_Deaths_Cumulative","IC_Discharge_Cumulative","IC_Discharge_InHospital","Hospital_Cumulative","Hospital_Intake","IC_Intake","Hosp_Intake_Suspec_Cumul","IC_Intake_Suspected_Cumul","IC_Intake_Proven_Cumsum"
2020-02-27,2,2,1,0,13,9,13,61,0,0,0,64,4,1,2,0,1
2020-02-28,4,0,0,1,14,10,14,65,0,0,0,68,4,1,2,1,1
2020-02-29,1,0,1,0,15,10,15,65,0,0,0,69,1,1,2,1,2
2020-03-01,7,1,2,0,17,11,17,72,0,0,1,76,8,2,3,1,4
2020-03-02,10,1,0,0,16,10,17,83,0,0,1,87,11,0,4,1,4
2020-03-03,8,0,2,0,18,10,19,90,0,0,1,95,8,2,4,1,6
2020-03-04,10,3,3,0,21,12,22,102,0,2,1,108,13,3,7,1,9
2020-03-05,11,1,1,1,21,14,24,111,0,2,1,119,12,2,8,2,10
2020-03-06,21,1,4,0,24,17,28,129,0,2,2,138,22,4,9,2,14
2020-03-07,7,3,3,0,26,17,31,137,0,3,1,146,10,3,12,2,17
2020-03-08,18,5,5,0,32,21,36,156,2,3,1,167,23,5,17,2,22
2020-03-09,27,5,6,1,37,22,43,181,2,3,1,197,32,7,22,3,28
2020-03-10,28,4,10,0,45,25,53,204,2,3,2,226,32,10,26,3,38
2020-03-11,44,5,9,0,52,26,62,240,4,3,2,269,49,9,31,3,47
2020-03-12,54,4,23,0,72,32,85,283,5,3,2,320,58,23,35,3,70
2020-03-13,76,4,13,0,82,35,98,352,5,4,2,398,80,13,39,3,83
2020-03-14,61,3,21,0,101,44,119,391,5,7,5,452,64,21,42,3,104
2020-03-15,69,8,28,0,123,51,147,439,7,7,6,523,77,28,50,3,132
2020-03-16,142,19,33,0,153,57,180,572,12,8,6,677,161,33,69,3,165
2020-03-17,145,12,35,0,182,60,215,656,14,8,9,816,157,35,81,3,200
2020-03-18,177,14,56,0,233,65,271,784,17,11,10,993,191,56,95,3,256
2020-03-19,261,24,66,1,293,70,338,993,25,11,12,1261,285,67,119,4,322
2020-03-20,240,25,83,1,365,71,421,1166,30,13,17,1505,265,84,144,5,405
2020-03-21,204,13,80,3,435,71,505,1245,41,15,27,1686,217,83,157,8,485
2020-03-22,236,17,74,1,486,71,580,1346,47,17,30,1908,253,75,174,9,559
2020-03-23,454,23,97,1,575,71,679,1674,64,19,42,2344,477,98,197,10,656
2020-03-24,428,24,111,0,654,73,790,1926,74,22,47,2752,452,111,221,10,767
2020-03-25,442,21,120,1,754,74,911,2143,85,28,54,3165,463,121,242,11,887
2020-03-26,444,31,111,2,840,74,1024,2341,103,38,58,3589,475,113,273,13,998
2020-03-27,562,33,114,1,923,74,1141,2600,117,44,75,4125,595,115,306,14,1112
2020-03-28,303,23,102,2,987,74,1245,2539,135,48,91,4399,326,104,329,16,1214
2020-03-29,258,17,91,1,1038,74,1337,2492,160,58,104,4625,275,92,346,17,1305
2020-03-30,442,29,127,2,1122,74,1466,2638,180,66,123,5025,471,129,375,19,1432
2020-03-31,309,40,111,0,1187,74,1577,2566,213,81,133,5314,349,111,415,19,1543
2020-04-01,316,35,75,2,1205,75,1654,2468,237,99,143,5617,351,77,450,21,1618
2020-04-02,350,37,96,2,1250,75,1752,2446,259,114,153,5947,387,98,487,23,1714
2020-04-03,340,49,77,0,1277,75,1829,2452,290,135,161,6295,389,77,536,23,1791
2020-04-04,187,24,64,2,1282,74,1895,2241,309,149,177,6460,211,66,560,25,1855
2020-04-05,230,20,75,1,1306,75,1971,2191,333,158,197,6657,250,76,580,26,1930
2020-04-06,328,51,61,0,1313,75,2032,2311,353,181,210,6995,379,61,631,26,1991
2020-04-07,204,51,60,0,1315,76,2092,2171,382,205,240,7211,255,60,682,26,2051
2020-04-08,209,31,58,0,1286,76,2150,2031,399,230,251,7411,240,58,713,26,2109
2020-04-09,188,35,52,0,1283,76,2202,1856,411,257,257,7596,223,52,748,26,2161
2020-04-10,205,38,49,0,1290,75,2252,1767,439,283,264,7806,243,49,786,26,2210
2020-04-11,133,20,28,2,1260,75,2282,1580,454,304,283,7937,153,30,806,28,2238
2020-04-12,137,32,33,1,1241,75,2316,1524,469,321,310,8088,169,34,838,29,2271
2020-04-13,167,30,45,0,1224,75,2361,1515,490,336,334,8251,197,45,868,29,2316
2020-04-14,162,33,35,2,1202,76,2399,1529,502,385,326,8419,195,37,901,31,2351
2020-04-15,119,16,24,1,1177,76,2424,1443,518,437,325,8536,135,25,917,32,2375
2020-04-16,117,20,28,1,1143,76,2454,1331,537,488,310,8651,137,29,937,33,2403
2020-04-17,139,23,25,1,1112,77,2480,1289,555,536,308,8788,162,26,960,34,2428
2020-04-18,80,15,19,0,1067,76,2499,1149,566,559,325,8861,95,19,975,34,2447
2020-04-19,82,13,20,0,1036,76,2519,1121,585,565,349,8938,95,20,988,34,2467
2020-04-20,111,21,26,1,1015,76,2546,1160,604,618,336,9042,132,27,1009,35,2493
2020-04-21,118,25,23,0,980,76,2569,1114,623,671,335,9156,143,23,1034,35,2516
2020-04-22,91,21,15,0,922,77,2584,1034,640,715,330,9254,112,15,1055,35,2531
2020-04-23,95,35,16,0,881,77,2600,993,652,762,309,9367,130,16,1090,35,2547
2020-04-24,78,24,18,1,865,76,2619,937,664,826,275,9452,102,19,1114,36,2565
2020-04-25,42,20,14,0,833,76,2633,808,678,842,284,9506,62,14,1134,36,2579
2020-04-26,43,22,13,0,806,76,2646,778,688,852,297,9560,65,13,1156,36,2592
2020-04-27,60,17,14,0,785,76,2660,763,699,861,314,9626,77,14,1173,36,2606
2020-04-28,91,24,14,1,764,76,2675,779,705,912,298,9721,115,15,1197,37,2620
2020-04-29,60,18,12,0,736,76,2687,721,711,949,297,9782,78,12,1215,37,2632
2020-04-30,63,18,17,1,712,76,2705,697,724,991,283,9851,81,18,1233,38,2649
2020-05-01,52,8,9,0,678,76,2714,643,726,1029,287,9900,60,9,1241,38,2658
2020-05-02,27,12,9,0,639,76,2723,560,735,1044,287,9933,39,9,1253,38,2667
2020-05-03,37,9,11,0,626,76,2734,544,740,1051,302,9969,46,11,1262,38,2678
2020-05-04,59,23,11,1,615,76,2746,592,746,1094,296,10038,82,12,1285,39,2689
2020-05-05,28,6,3,0,574,76,2749,525,751,1108,309,10068,34,3,1291,39,2692
2020-05-06,59,15,7,0,548,73,2756,540,757,1144,301,10133,74,7,1306,39,2699
2020-05-07,46,13,9,1,527,72,2766,514,765,1183,294,10180,59,10,1319,40,2708
2020-05-08,56,25,7,0,495,72,2773,513,770,1220,279,10254,81,7,1344,40,2715
2020-05-09,30,5,5,0,473,72,2778,465,775,1228,288,10285,35,5,1349,40,2720
2020-05-10,25,12,4,0,455,72,2782,447,776,1231,297,10315,37,4,1361,40,2724
2020-05-11,44,19,7,1,449,73,2790,476,783,1272,292,10373,63,8,1380,41,2731
2020-05-12,27,20,2,0,407,71,2792,447,786,1314,268,10415,47,2,1400,41,2733
2020-05-13,37,18,3,1,391,71,2796,421,791,1346,266,10464,55,4,1418,42,2736
2020-05-14,26,13,8,1,365,71,2805,388,795,1373,252,10494,39,9,1431,43,2744
2020-05-15,31,13,3,0,348,71,2808,367,802,1409,229,10533,44,3,1444,43,2747
2020-05-16,18,4,7,1,333,70,2816,324,804,1418,229,10551,22,8,1448,44,2754
2020-05-17,30,10,4,0,327,70,2820,338,805,1422,233,10586,40,4,1458,44,2758
2020-05-18,36,12,4,0,322,70,2824,370,806,1455,235,10628,48,4,1470,44,2762
2020-05-19,17,10,1,0,288,67,2825,346,808,1487,214,10653,27,1,1480,44,2763
2020-05-20,31,13,2,0,278,66,2827,332,813,1516,201,10691,44,2,1493,44,2765
2020-05-21,14,5,2,0,257,66,2829,298,817,1521,207,10705,19,2,1498,44,2767
2020-05-22,32,17,4,0,246,65,2833,328,820,1553,190,10748,49,4,1515,44,2771
2020-05-23,14,8,4,0,231,64,2837,292,821,1556,194,10767,22,4,1523,44,2775
2020-05-24,18,15,7,0,230,64,2844,284,822,1556,204,10791,33,7,1538,44,2782
2020-05-25,35,21,1,0,220,63,2845,319,823,1579,208,10842,56,1,1559,44,2783
2020-05-26,25,10,4,0,197,64,2849,313,827,1600,199,10874,35,4,1569,44,2787
2020-05-27,16,10,3,1,183,60,2853,283,828,1623,184,10896,26,4,1579,45,2790
2020-05-28,16,8,1,0,175,59,2854,262,830,1653,165,10915,24,1,1587,45,2791
2020-05-29,24,12,1,2,165,58,2857,264,833,1674,152,10946,36,3,1599,47,2792
2020-05-30,19,5,3,0,156,57,2860,247,833,1681,146,10967,24,3,1604,47,2795
2020-05-31,12,7,3,0,158,57,2863,242,833,1681,153,10985,19,3,1611,47,2798
2020-06-01,15,6,5,0,156,58,2868,246,836,1681,156,11002,21,5,1617,47,2803
2020-06-02,24,17,1,0,151,58,2869,268,837,1705,150,11038,41,1,1634,47,2804
2020-06-03,19,8,5,0,137,55,2874,259,842,1726,133,11056,27,5,1642,47,2809
2020-06-04,14,16,5,1,135,56,2880,244,845,1746,116,11077,30,6,1658,48,2814
2020-06-05,9,12,3,0,132,54,2883,227,845,1757,108,11095,21,3,1670,48,2817
2020-06-06,4,5,2,0,130,54,2885,194,846,1759,109,11102,9,2,1675,48,2819
2020-06-07,5,11,3,0,129,54,2888,194,846,1761,109,11116,16,3,1686,48,2822
2020-06-08,11,6,0,0,127,54,2888,194,846,1778,101,11133,17,0,1692,48,2822
2020-06-09,9,8,2,0,120,53,2890,174,847,1791,93,11148,17,2,1700,48,2824
2020-06-10,5,6,2,0,117,53,2892,158,848,1803,84,11157,11,2,1706,48,2826
2020-06-11,14,10,1,0,113,53,2893,162,848,1815,77,11177,24,1,1716,48,2827
2020-06-12,8,3,3,0,110,51,2896,153,849,1824,71,11187,11,3,1719,48,2830
2020-06-13,4,4,2,0,108,49,2898,134,850,1824,71,11193,8,2,1723,48,2832
2020-06-14,3,5,0,0,107,48,2898,133,852,1826,69,11201,8,0,1728,48,2832
2020-06-15,5,4,1,0,106,48,2899,136,853,1844,61,11209,9,1,1732,48,2833
2020-06-16,8,7,2,0,97,47,2901,136,856,1849,61,11223,15,2,1739,48,2835
2020-06-17,7,6,0,0,88,44,2901,128,858,1856,59,11234,13,0,1745,48,2835
2020-06-18,4,10,1,0,81,43,2902,129,859,1863,60,11247,14,1,1755,48,2836
2020-06-19,4,6,0,0,74,43,2902,125,860,1871,52,11256,10,0,1761,48,2836
2020-06-20,4,4,2,0,74,43,2904,106,861,1872,55,11261,8,2,1765,48,2838
2020-06-21,5,7,0,0,70,41,2904,107,862,1872,55,11272,12,0,1772,48,2838
2020-06-22,7,6,3,0,72,43,2907,110,863,1876,58,11284,13,3,1778,48,2841
2020-06-23,6,9,1,0,65,40,2908,111,864,1883,55,11294,15,1,1787,48,2842
2020-06-24,5,11,1,0,61,39,2909,110,865,1889,50,11309,16,1,1798,48,2843
2020-06-25,9,7,0,0,59,37,2909,117,865,1895,50,11323,16,0,1805,48,2843
2020-06-26,2,6,0,0,53,34,2909,113,866,1899,50,11329,8,0,1811,48,2843
2020-06-27,2,2,0,0,49,32,2909,92,867,1899,53,11333,4,0,1813,48,2843
2020-06-28,5,3,0,0,45,31,2909,96,867,1899,53,11341,8,0,1816,48,2843
2020-06-29,8,5,0,0,45,31,2909,105,867,1904,50,11351,13,0,1821,48,2843
2020-06-30,3,5,2,0,45,31,2911,91,867,1911,46,11356,8,2,1826,48,2845
2020-07-01,4,5,0,0,41,28,2911,89,867,1916,42,11365,9,0,1831,48,2845
2020-07-02,4,2,2,1,43,31,2914,82,868,1920,40,11368,6,3,1833,49,2847
2020-07-03,6,4,0,0,40,30,2914,82,868,1930,30,11376,10,0,1837,49,2847
2020-07-04,0,3,1,0,41,30,2915,72,868,1930,32,11378,3,1,1840,49,2848
2020-07-05,2,6,0,0,39,28,2915,75,868,1931,32,11384,8,0,1846,49,2848
2020-07-06,2,4,0,0,38,27,2915,79,869,1936,29,11390,6,0,1850,49,2848
2020-07-07,4,4,1,0,36,26,2916,81,870,1938,29,11397,8,1,1854,49,2849
2020-07-08,4,3,2,0,33,26,2918,79,870,1943,25,11403,7,2,1857,49,2851
2020-07-09,6,5,1,0,33,25,2919,79,870,1947,21,11411,11,1,1862,49,2852
2020-07-10,7,6,1,0,34,25,2920,89,870,1947,22,11422,13,1,1868,49,2853
2020-07-11,2,2,0,0,32,23,2920,81,870,1947,22,11425,4,0,1870,49,2853
2020-07-12,3,3,1,0,33,23,2921,81,871,1949,21,11428,6,1,1873,49,2854
2020-07-13,5,4,0,0,32,23,2921,88,872,1950,22,11437,9,0,1877,49,2854
2020-07-14,6,4,0,0,29,23,2921,89,872,1951,22,11446,10,0,1881,49,2854
2020-07-15,2,4,1,0,29,23,2922,82,872,1953,22,11451,6,1,1885,49,2855
2020-07-16,2,6,1,0,28,23,2923,78,872,1958,17,11458,8,1,1891,49,2856
2020-07-17,6,1,0,0,28,22,2923,76,872,1958,18,11464,7,0,1892,49,2856
2020-07-18,6,7,0,0,27,22,2923,83,872,1958,18,11477,13,0,1899,49,2856
2020-07-19,7,1,1,0,28,22,2924,86,872,1958,19,11485,8,1,1900,49,2857
2020-07-20,4,4,0,1,28,23,2925,89,873,1963,15,11492,8,1,1904,50,2857
2020-07-21,6,5,2,0,28,22,2927,88,873,1965,16,11501,11,2,1909,50,2859
2020-07-22,4,1,1,0,28,21,2928,77,874,1969,14,11505,5,1,1910,50,2860
2020-07-23,10,6,1,0,26,20,2929,84,874,1971,14,11519,16,1,1916,50,2861
2020-07-24,10,0,1,0,25,19,2930,82,874,1975,14,11528,10,1,1916,50,2862
2020-07-25,10,3,1,0,22,19,2931,85,874,1976,15,11540,13,1,1919,50,2863
2020-07-26,4,2,3,0,23,20,2934,87,874,1976,15,11544,6,3,1921,50,2866
2020-07-27,6,5,3,0,26,21,2937,95,874,1978,13,11554,11,3,1926,50,2869
2020-07-28,10,2,0,0,26,21,2937,98,874,1979,12,11566,12,0,1928,50,2869
2020-07-29,4,0,0,0,25,21,2937,89,875,1980,12,11569,4,0,1928,50,2869
2020-07-30,15,3,3,0,27,22,2940,93,875,1982,10,11586,18,3,1931,50,2872
2020-07-31,11,1,4,0,30,24,2944,97,877,1982,9,11596,12,4,1932,50,2876
2020-08-01,8,3,2,0,31,24,2946,98,877,1983,9,11606,11,2,1935,50,2878
2020-08-02,11,2,2,0,32,24,2948,108,877,1983,9,11618,13,2,1937,50,2880
2020-08-03,15,3,3,0,35,24,2951,118,877,1983,10,11635,18,3,1940,50,2883
2020-08-04,8,3,3,0,37,26,2954,111,878,1984,11,11644,11,3,1943,50,2886
2020-08-05,8,3,2,0,36,25,2956,106,878,1987,8,11654,11,2,1946,50,2888
2020-08-06,11,2,3,0,39,27,2959,105,879,1988,7,11664,13,3,1948,50,2891
2020-08-07,14,2,1,0,39,27,2960,112,879,1989,6,11680,16,1,1950,50,2892
2020-08-08,18,1,1,0,40,28,2961,119,879,1989,7,11699,19,1,1951,50,2893
2020-08-09,19,4,5,1,45,32,2967,132,881,1990,10,11718,23,6,1955,51,2898
2020-08-10,15,4,4,0,43,32,2971,142,881,1991,10,11736,19,4,1959,51,2902
2020-08-11,27,6,3,0,45,32,2974,161,882,1992,12,11767,33,3,1965,51,2905
2020-08-12,20,0,4,0,45,30,2978,163,882,1993,17,11783,20,4,1965,51,2909
2020-08-13,19,5,4,0,43,30,2982,163,882,1993,18,11804,24,4,1970,51,2913
2020-08-14,12,3,6,0,48,32,2988,158,882,1994,20,11815,15,6,1973,51,2919
2020-08-15,15,3,1,0,46,32,2989,154,883,1994,22,11833,18,1,1976,51,2920
2020-08-16,17,4,4,0,47,33,2993,163,883,1995,21,11852,21,4,1980,51,2924
2020-08-17,19,8,7,1,55,37,3001,180,885,1998,22,11876,27,8,1988,52,2931
2020-08-18,11,1,2,0,51,37,3003,175,885,2002,21,11886,12,2,1989,52,2933
2020-08-19,17,2,3,0,50,36,3006,178,885,2008,19,11901,19,3,1991,52,2936
2020-08-20,24,2,6,0,52,39,3012,187,886,2011,15,11923,26,6,1993,52,2942
2020-08-21,18,9,5,0,55,38,3017,181,887,2014,15,11946,27,5,2002,52,2947
2020-08-22,10,4,0,0,51,36,3017,161,887,2014,17,11960,14,0,2006,52,2947
2020-08-23,14,2,5,0,53,38,3022,162,887,2015,17,11972,16,5,2008,52,2952
2020-08-24,11,4,2,0,53,39,3024,166,888,2016,23,11985,15,2,2012,52,2954
2020-08-25,20,3,3,0,48,34,3027,173,888,2017,24,12005,23,3,2015,52,2957
2020-08-26,12,6,0,0,46,34,3027,163,888,2023,21,12023,18,0,2021,52,2957
2020-08-27,7,1,2,0,45,33,3029,148,888,2027,21,12030,8,2,2022,52,2959
2020-08-28,12,2,2,0,43,34,3031,150,889,2032,17,12042,14,2,2024,52,2961
2020-08-29,2,2,3,0,44,33,3034,133,889,2033,16,12045,4,3,2026,52,2964
2020-08-30,10,2,3,0,49,36,3037,135,890,2033,17,12057,12,3,2028,52,2967
2020-08-31,16,3,1,0,48,35,3038,146,892,2036,17,12075,19,1,2031,52,2968
2020-09-01,14,1,2,0,44,36,3040,145,893,2038,17,12088,15,2,2032,52,2970
2020-09-02,17,9,2,0,43,35,3042,151,893,2040,17,12111,26,2,2041,52,2972
2020-09-03,12,3,3,0,44,33,3045,146,893,2043,14,12124,15,3,2044,52,2975
2020-09-04,17,5,4,0,48,35,3049,153,894,2044,17,12144,22,4,2049,52,2979
2020-09-05,18,3,1,0,44,34,3050,153,894,2044,18,12163,21,1,2052,52,2980
2020-09-06,23,6,4,0,48,35,3054,171,894,2044,19,12186,29,4,2058,52,2984
2020-09-07,29,5,3,0,49,35,3057,192,894,2045,21,12217,34,3,2063,52,2987
2020-09-08,23,5,3,0,48,32,3060,206,895,2045,24,12244,28,3,2068,52,2990
2020-09-09,34,10,4,0,49,32,3064,226,896,2047,23,12286,44,4,2078,52,2994
2020-09-10,18,4,5,0,52,32,3069,220,897,2049,21,12305,22,5,2082,52,2999
2020-09-11,42,3,6,0,57,34,3075,240,897,2051,21,12342,45,6,2085,52,3005
2020-09-12,20,1,6,0,61,36,3081,237,897,2052,22,12361,21,6,2086,52,3011
2020-09-13,25,5,4,0,63,37,3085,250,897,2052,22,12389,30,4,2091,52,3015
2020-09-14,52,8,10,1,74,39,3096,291,898,2055,23,12446,60,11,2099,53,3025
2020-09-15,40,3,4,0,74,39,3100,299,899,2059,24,12486,43,4,2102,53,3029
2020-09-16,49,7,1,0,69,40,3101,326,900,2060,26,12540,56,1,2109,53,3030
2020-09-17,55,8,5,0,70,41,3106,344,900,2066,25,12598,63,5,2117,53,3035
2020-09-18,80,2,7,0,73,40,3113,382,900,2068,25,12670,82,7,2119,53,3042
2020-09-19,60,5,14,0,86,45,3127,400,901,2070,24,12728,65,14,2124,53,3056
2020-09-20,51,2,13,0,97,47,3140,420,902,2070,27,12772,53,13,2126,53,3069
2020-09-21,81,3,13,0,106,49,3153,472,905,2073,23,12851,84,13,2129,53,3082
2020-09-22,71,3,10,0,113,52,3164,502,905,2076,24,12919,74,10,2132,53,3092
2020-09-23,96,6,13,0,122,54,3177,545,906,2081,23,13012,102,13,2138,53,3105
2020-09-24,106,7,11,0,129,57,3188,594,907,2083,24,13117,113,11,2145,53,3116
2020-09-25,92,6,18,0,143,58,3206,622,909,2087,24,13203,98,18,2151,53,3134
2020-09-26,79,2,13,0,148,60,3219,617,910,2088,29,13276,81,13,2153,53,3147
2020-09-27,82,4,17,1,159,60,3237,650,912,2088,36,13352,86,18,2157,54,3164
2020-09-28,112,3,15,0,166,61,3252,705,914,2091,43,13457,115,15,2160,54,3179
2020-09-29,100,6,22,1,176,63,3275,742,916,2094,51,13550,106,23,2166,55,3201
2020-09-30,113,1,15,0,177,63,3290,759,919,2097,55,13656,114,15,2167,55,3216
2020-10-01,111,12,13,0,181,65,3303,787,923,2105,55,13772,123,13,2179,55,3229
2020-10-02,122,4,14,0,181,64,3317,809,923,2108,61,13886,126,14,2183,55,3243
2020-10-03,137,5,19,0,191,68,3336,831,925,2112,65,14016,142,19,2188,55,3262
2020-10-04,104,3,21,0,202,68,3357,871,930,2116,68,14115,107,21,2191,55,3283
2020-10-05,165,5,28,0,217,67,3385,976,933,2120,71,14273,170,28,2196,55,3311
2020-10-06,156,3,34,0,239,69,3419,1021,935,2132,74,14415,159,34,2199,55,3345
2020-10-07,147,5,29,1,252,69,3449,1044,939,2141,76,14555,152,30,2204,56,3374
2020-10-08,161,3,22,0,258,69,3471,1072,942,2148,77,14703,164,22,2207,56,3396
2020-10-09,209,6,28,0,274,70,3499,1148,953,2158,83,14897,215,28,2213,56,3424
2020-10-10,152,3,27,0,273,70,3526,1130,956,2168,82,15035,155,27,2216,56,3451
2020-10-11,159,3,19,0,279,68,3545,1188,963,2172,91,15189,162,19,2219,56,3470
2020-10-12,241,3,41,0,302,68,3586,1335,967,2182,91,15406,244,41,2222,56,3511
2020-10-13,247,6,36,0,321,72,3622,1432,970,2195,90,15636,253,36,2228,56,3547
2020-10-14,205,4,35,0,341,72,3657,1426,976,2202,96,15822,209,35,2232,56,3582
2020-10-15,219,6,36,2,359,72,3695,1453,978,2211,106,16018,225,38,2238,58,3618
2020-10-16,221,6,55,0,396,73,3750,1502,990,2231,106,16216,227,55,2244,58,3673
2020-10-17,214,3,30,0,391,74,3780,1493,996,2237,111,16410,217,30,2247,58,3703
2020-10-18,188,5,41,0,414,74,3821,1528,1001,2242,121,16575,193,41,2252,58,3744
2020-10-19,284,11,58,1,452,76,3881,1680,1006,2253,129,16832,295,59,2263,59,3802
2020-10-20,243,13,49,1,478,74,3931,1738,1014,2271,131,17052,256,50,2276,60,3851
2020-10-21,273,3,48,0,493,75,3979,1772,1024,2284,139,17300,276,48,2279,60,3899
2020-10-22,281,4,43,0,506,75,4022,1844,1032,2305,148,17558,285,43,2283,60,3942
2020-10-23,310,10,53,0,520,75,4075,1925,1051,2323,144,17847,320,53,2293,60,3995
2020-10-24,208,7,36,1,524,74,4112,1857,1058,2334,159,18037,215,37,2300,61,4031
2020-10-25,252,7,47,0,540,73,4159,1929,1074,2344,166,18263,259,47,2307,61,4078
2020-10-26,341,3,60,0,567,75,4219,2089,1080,2362,182,18563,344,60,2310,61,4138
2020-10-27,292,3,49,0,578,76,4268,2098,1092,2388,176,18824,295,49,2313,61,4187
2020-10-28,276,6,51,0,596,76,4319,2075,1098,2409,187,19075,282,51,2319,61,4238
2020-10-29,273,9,46,0,607,76,4365,2046,1107,2428,190,19317,282,46,2328,61,4284
2020-10-30,290,12,42,0,614,75,4407,2066,1119,2451,194,19584,302,42,2340,61,4326
2020-10-31,201,6,48,0,623,76,4455,1987,1136,2460,200,19767,207,48,2346,61,4374
2020-11-01,220,3,43,0,632,77,4498,2009,1147,2468,215,19961,223,43,2349,61,4417
2020-11-02,385,12,59,0,658,77,4558,2218,1156,2494,219,20313,397,59,2361,61,4476
2020-11-03,239,5,31,1,653,77,4590,2165,1167,2521,215,20527,244,32,2366,62,4507
2020-11-04,246,5,39,0,658,76,4630,2098,1180,2551,210,20735,251,39,2371,62,4546
2020-11-05,242,4,35,0,650,76,4665,2027,1196,2583,200,20951,246,35,2375,62,4581
2020-11-06,241,8,35,0,647,76,4700,1951,1212,2609,206,21173,249,35,2383,62,4616
2020-11-07,153,9,39,0,639,76,4739,1801,1224,2618,221,21303,162,39,2392,62,4655
2020-11-08,160,2,44,0,644,76,4783,1781,1235,2628,240,21434,162,44,2394,62,4699
2020-11-09,296,6,41,0,645,77,4824,1926,1248,2662,228,21701,302,41,2400,62,4740
2020-11-10,226,7,37,0,648,77,4861,1863,1263,2690,226,21898,233,37,2407,62,4777
2020-11-11,235,4,36,0,643,77,4897,1817,1274,2719,220,22102,239,36,2411,62,4813
2020-11-12,206,8,41,0,648,77,4938,1765,1286,2746,211,22279,214,41,2419,62,4854
2020-11-13,246,6,31,0,650,77,4969,1746,1301,2785,210,22499,252,31,2425,62,4885
2020-11-14,141,3,22,0,617,77,4991,1612,1312,2792,223,22618,144,22,2428,62,4907
2020-11-15,146,9,34,0,621,76,5025,1607,1330,2801,238,22747,155,34,2437,62,4941
2020-11-16,255,16,36,0,617,76,5061,1754,1346,2827,237,22975,271,36,2453,62,4977
2020-11-17,201,10,29,0,604,76,5090,1725,1362,2859,233,23156,211,29,2463,62,5006
2020-11-18,194,6,31,0,588,76,5121,1667,1375,2885,230,23328,200,31,2469,62,5037
2020-11-19,192,12,39,0,590,76,5160,1606,1388,2915,227,23497,204,39,2481,62,5076
2020-11-20,171,4,28,1,581,76,5189,1516,1402,2945,219,23649,175,29,2485,63,5104
2020-11-21,141,2,21,0,567,76,5210,1419,1415,2952,227,23774,143,21,2487,63,5125
2020-11-22,167,7,25,0,562,76,5235,1453,1429,2958,230,23926,174,25,2494,63,5150
2020-11-23,220,8,26,0,564,76,5261,1583,1446,2988,224,24122,228,26,2502,63,5176
2020-11-24,155,13,34,0,557,76,5296,1536,1460,3017,218,24266,168,34,2515,63,5210
2020-11-25,163,3,41,0,563,77,5337,1465,1474,3044,211,24399,166,41,2518,63,5251
2020-11-26,192,7,30,0,558,76,5367,1471,1488,3065,209,24569,199,30,2525,63,5281
2020-11-27,181,10,17,0,541,75,5384,1463,1496,3096,197,24735,191,17,2535,63,5298
2020-11-28,101,3,21,0,535,75,5405,1363,1510,3104,207,24817,104,21,2538,63,5319
2020-11-29,119,2,18,0,520,75,5424,1368,1520,3108,223,24925,121,18,2540,63,5337
2020-11-30,173,5,24,2,517,75,5450,1453,1532,3136,220,25071,178,26,2545,65,5361
2020-12-01,153,1,30,0,510,75,5480,1407,1543,3158,218,25203,154,30,2546,65,5391
2020-12-02,169,4,30,0,511,75,5510,1370,1555,3182,222,25346,173,30,2550,65,5421
2020-12-03,187,2,30,0,499,75,5540,1377,1562,3199,220,25508,189,30,2552,65,5451
2020-12-04,207,10,33,0,509,76,5573,1410,1573,3232,205,25693,217,33,2562,65,5484
2020-12-05,146,5,25,0,503,76,5598,1362,1583,3236,212,25828,151,25,2567,65,5509
2020-12-06,141,5,28,0,508,76,5626,1403,1594,3242,220,25949,146,28,2572,65,5537
2020-12-07,221,8,21,0,504,75,5647,1514,1602,3266,218,26159,229,21,2580,65,5558
2020-12-08,180,8,40,0,514,75,5687,1499,1615,3294,213,26316,188,40,2588,65,5598
2020-12-09,183,6,31,0,506,76,5718,1482,1626,3322,204,26475,189,31,2594,65,5629
2020-12-10,200,7,33,0,511,76,5751,1479,1635,3343,210,26654,207,33,2601,65,5662
2020-12-11,258,11,36,0,508,76,5787,1551,1643,3365,203,26886,269,36,2612,65,5698
2020-12-12,156,2,22,0,505,75,5809,1523,1650,3373,204,27030,158,22,2614,65,5720
2020-12-13,180,8,42,0,530,75,5851,1576,1658,3375,215,27186,188,42,2622,65,5762
2020-12-14,279,9,24,1,535,75,5876,1748,1665,3404,211,27443,288,25,2631,66,5786
2020-12-15,221,3,44,1,548,76,5921,1743,1672,3423,212,27625,224,45,2634,67,5830
2020-12-16,246,7,36,0,559,76,5957,1770,1686,3450,194,27852,253,36,2641,67,5866
2020-12-17,256,11,48,0,584,76,6005,1814,1695,3474,191,28093,267,48,2652,67,5914
2020-12-18,287,4,38,1,591,77,6044,1869,1702,3498,192,28358,291,39,2656,68,5952
2020-12-19,183,5,43,0,602,77,6087,1772,1714,3502,211,28518,188,43,2661,68,5995
2020-12-20,191,4,55,0,624,77,6142,1786,1730,3510,220,28678,195,55,2665,68,6050
2020-12-21,346,3,32,0,621,76,6174,1983,1742,3541,210,28987,349,32,2668,68,6082
2020-12-22,279,6,43,0,629,76,6217,2001,1752,3570,201,29237,285,43,2674,68,6125
2020-12-23,293,7,48,0,646,77,6265,2027,1763,3595,208,29498,300,48,2681,68,6173
2020-12-24,302,10,49,0,651,78,6314,2045,1776,3629,204,29769,312,49,2691,68,6222
2020-12-25,232,5,36,0,644,78,6350,1943,1790,3635,212,29978,237,36,2696,68,6258
2020-12-26,238,4,42,0,657,78,6392,1982,1799,3641,226,30181,242,42,2700,68,6300
2020-12-27,269,3,44,0,673,78,6436,2073,1813,3647,241,30410,272,44,2703,68,6344
2020-12-28,449,5,68,0,708,78,6505,2357,1825,3673,245,30815,454,68,2708,68,6412
2020-12-29,250,3,61,0,728,78,6567,2336,1833,3698,247,31022,253,61,2711,68,6473
2020-12-30,263,9,45,0,736,78,6613,2295,1845,3727,240,31257,272,45,2720,68,6518
2020-12-31,265,5,39,1,737,77,6653,2216,1862,3748,252,31493,270,40,2725,69,6557
2021-01-01,213,3,40,0,725,77,6693,2053,1872,3762,263,31691,216,40,2728,69,6597
2021-01-02,233,2,40,0,730,77,6733,2103,1886,3770,282,31893,235,40,2730,69,6637
2021-01-03,230,7,45,0,732,77,6778,2127,1902,3781,299,32095,237,45,2737,69,6682
2021-01-04,332,5,58,0,750,77,6836,2252,1915,3807,319,32375,337,58,2742,69,6740
2021-01-05,284,6,54,0,746,78,6890,2218,1936,3848,314,32614,290,54,2748,69,6794
2021-01-06,244,7,45,0,733,78,6935,2161,1949,3889,297,32827,251,45,2755,69,6839
2021-01-07,241,6,38,0,732,78,6973,2103,1970,3926,286,33034,247,38,2761,69,6877
2021-01-08,243,7,45,0,730,78,7018,2041,1992,3965,277,33235,250,45,2768,69,6922
2021-01-09,162,2,31,0,709,78,7049,1867,2005,3977,287,33372,164,31,2770,69,6953
2021-01-10,189,3,31,0,705,77,7080,1877,2011,3987,298,33537,192,31,2773,69,6984
2021-01-11,276,8,38,0,717,78,7118,2010,2029,4021,286,33790,284,38,2781,69,7022
2021-01-12,211,8,45,0,724,78,7163,1945,2037,4064,266,33966,219,45,2789,69,7067
2021-01-13,239,6,36,0,725,77,7199,1888,2054,4097,267,34176,245,36,2795,69,7103
2021-01-14,207,8,34,1,708,78,7233,1826,2063,4134,263,34362,215,35,2803,70,7137
2021-01-15,218,9,37,0,701,78,7270,1808,2075,4164,264,34556,227,37,2812,70,7174
2021-01-16,163,3,27,0,683,77,7297,1681,2086,4172,274,34698,166,27,2815,70,7201
2021-01-17,150,6,38,0,691,77,7335,1636,2091,4179,295,34827,156,38,2821,70,7239
2021-01-18,247,9,41,0,701,77,7376,1762,2107,4215,285,35047,256,41,2830,70,7280
2021-01-19,217,6,34,0,694,77,7410,1749,2116,4252,281,35238,223,34,2836,70,7314
2021-01-20,188,4,33,0,686,76,7443,1674,2127,4285,269,35395,192,33,2840,70,7347
2021-01-21,230,9,39,0,691,76,7483,1675,2142,4319,264,35601,239,39,2849,70,7386
2021-01-22,209,7,35,0,683,76,7518,1654,2154,4359,257,35782,216,35,2856,70,7421
2021-01-23,158,3,33,0,672,77,7551,1576,2164,4372,261,35922,161,33,2859,70,7454
2021-01-24,153,1,26,0,670,77,7577,1586,2176,4376,279,36053,154,26,2860,70,7480
2021-01-25,210,6,54,1,693,77,7632,1681,2189,4414,269,36238,216,55,2866,71,7534
2021-01-26,175,8,34,0,684,77,7666,1635,2205,4444,279,36384,183,34,2874,71,7568
2021-01-27,183,6,28,0,658,78,7694,1573,2219,4469,278,36539,189,28,2880,71,7596
2021-01-28,204,3,43,1,660,77,7738,1532,2228,4495,277,36707,207,44,2883,72,7639
2021-01-29,218,6,27,0,655,78,7765,1543,2245,4524,279,36906,224,27,2889,72,7666
2021-01-30,132,4,31,0,641,78,7796,1473,2252,4536,279,37019,136,31,2893,72,7697
2021-01-31,149,6,35,1,657,78,7832,1508,2265,4541,289,37143,155,36,2899,73,7732
2021-02-01,233,6,29,1,660,78,7862,1614,2277,4575,291,37339,239,30,2905,74,7761
2021-02-02,179,7,28,0,641,78,7890,1581,2292,4606,289,37501,186,28,2912,74,7789
2021-02-03,169,7,30,0,627,78,7920,1523,2302,4649,284,37653,176,30,2919,74,7819
2021-02-04,186,11,26,0,602,78,7946,1491,2311,4690,279,37821,197,26,2930,74,7845
2021-02-05,182,12,19,0,571,77,7965,1482,2326,4731,270,37998,194,19,2942,74,7864
2021-02-06,129,3,21,0,545,77,7986,1357,2339,4739,284,38111,132,21,2945,74,7885
2021-02-07,119,2,21,0,531,77,8007,1340,2347,4744,291,38208,121,21,2947,74,7906
2021-02-08,191,4,32,0,543,78,8039,1445,2349,4783,273,38373,195,32,2951,74,7938
2021-02-09,189,5,19,1,540,78,8059,1419,2361,4827,247,38552,194,20,2956,75,7957
2021-02-10,191,5,28,0,540,77,8087,1420,2371,4863,231,38715,196,28,2961,75,7985
2021-02-11,176,8,32,0,538,75,8119,1406,2379,4893,228,38868,184,32,2969,75,8017
2021-02-12,181,4,33,0,534,75,8152,1383,2388,4923,218,39024,185,33,2973,75,8050
2021-02-13,113,3,22,0,528,76,8174,1286,2395,4932,223,39126,116,22,2976,75,8072
2021-02-14,140,4,26,0,533,76,8200,1292,2406,4936,231,39247,144,26,2980,75,8098
2021-02-15,218,4,36,0,546,76,8236,1406,2413,4970,232,39441,222,36,2984,75,8134
2021-02-16,176,5,39,0,541,78,8275,1390,2420,5002,225,39594,181,39,2989,75,8173
2021-02-17,164,10,36,0,541,78,8311,1374,2427,5029,229,39734,174,36,2999,75,8209
2021-02-18,196,8,26,1,529,78,8338,1381,2433,5052,230,39912,204,27,3007,76,8235
2021-02-19,159,5,32,0,532,77,8370,1360,2441,5087,219,40056,164,32,3012,76,8267
2021-02-20,126,3,40,0,538,77,8410,1265,2449,5095,224,40157,129,40,3015,76,8307
2021-02-21,126,7,36,0,554,77,8446,1264,2452,5100,236,40260,133,36,3022,76,8343
2021-02-22,212,9,32,0,566,77,8478,1375,2462,5127,240,40451,221,32,3031,76,8375
2021-02-23,163,6,26,0,553,77,8504,1364,2467,5150,245,40591,169,26,3037,76,8401
2021-02-24,176,8,29,1,549,77,8534,1347,2477,5183,235,40748,184,30,3045,77,8430
2021-02-25,154,7,47,0,560,78,8581,1308,2485,5206,249,40871,161,47,3052,77,8477
2021-02-26,193,8,29,0,545,77,8610,1296,2493,5231,255,41036,201,29,3060,77,8506
2021-02-27,133,3,20,0,526,77,8631,1240,2497,5244,260,41154,136,20,3063,77,8526
2021-02-28,147,9,42,0,545,77,8673,1256,2503,5248,272,41276,156,42,3072,77,8568
2021-03-01,231,8,50,1,576,78,8724,1380,2512,5284,271,41471,239,51,3080,78,8618
2021-03-02,169,7,39,0,570,78,8763,1361,2525,5326,261,41606,176,39,3087,78,8657
2021-03-03,150,6,34,0,559,78,8797,1314,2531,5360,250,41728,156,34,3093,78,8691
2021-03-04,171,5,42,0,572,78,8839,1295,2539,5392,251,41868,176,42,3098,78,8733
2021-03-05,172,8,36,0,566,78,8875,1279,2544,5430,243,42023,180,36,3106,78,8769
2021-03-06,115,9,38,0,575,78,8913,1196,2554,5442,251,42122,124,38,3115,78,8807
2021-03-07,150,5,33,0,576,76,8946,1217,2560,5452,252,42254,155,33,3120,78,8840
2021-03-08,220,7,42,0,600,77,8988,1328,2569,5479,258,42443,227,42,3127,78,8882
2021-03-09,184,8,35,0,591,78,9023,1329,2573,5517,247,42608,192,35,3135,78,8917
2021-03-10,182,11,43,0,602,78,9066,1302,2580,5545,251,42766,193,43,3146,78,8960
2021-03-11,190,4,42,0,603,78,9108,1292,2590,5572,253,42921,194,42,3150,78,9002
2021-03-12,188,7,31,0,593,78,9139,1297,2603,5606,253,43088,195,31,3157,78,9033
2021-03-13,162,8,34,0,579,78,9173,1261,2609,5615,270,43235,170,34,3165,78,9067
2021-03-14,155,6,41,0,584,78,9214,1287,2617,5620,288,43366,161,41,3171,78,9108
2021-03-15,222,3,45,0,599,78,9259,1407,2625,5660,274,43555,225,45,3174,78,9153
2021-03-16,209,4,45,0,609,78,9304,1411,2637,5697,280,43734,213,45,3178,78,9198
2021-03-17,192,9,38,0,591,78,9342,1398,2650,5729,282,43897,201,38,3187,78,9236
2021-03-18,231,8,54,0,598,77,9396,1439,2660,5760,277,44097,239,54,3195,78,9290
2021-03-19,223,3,48,0,610,77,9444,1450,2669,5804,253,44292,226,48,3198,78,9338
2021-03-20,176,1,38,0,618,78,9482,1406,2679,5813,267,44429,177,38,3199,78,9376
2021-03-21,193,3,52,0,636,78,9534,1454,2684,5816,284,44586,196,52,3202,78,9428
2021-03-22,278,4,40,0,648,78,9574,1589,2693,5860,274,44829,282,40,3206,78,9468
2021-03-23,218,9,42,0,643,78,9616,1555,2702,5901,263,45029,227,42,3215,78,9510
2021-03-24,237,7,37,0,641,78,9654,1562,2708,5938,259,45241,244,37,3222,78,9547
2021-03-25,239,7,58,0,658,78,9713,1557,2720,5973,264,45439,246,58,3229,78,9605
2021-03-26,276,3,60,0,663,77,9773,1579,2730,6006,259,45666,279,60,3232,78,9665
2021-03-27,157,6,40,0,666,78,9813,1505,2735,6021,268,45798,163,40,3238,78,9705
2021-03-28,190,5,34,0,672,78,9848,1525,2742,6029,276,45960,195,34,3243,78,9739
2021-03-29,334,11,48,0,694,78,9896,1713,2752,6067,277,46262,345,48,3254,78,9787
2021-03-30,240,5,51,0,695,78,9947,1689,2765,6106,275,46457,245,51,3259,78,9838
2021-03-31,250,10,60,0,709,78,10007,1649,2777,6145,271,46661,260,60,3269,78,9898
2021-04-01,262,4,46,0,703,78,10053,1664,2788,6177,265,46884,266,46,3273,78,9944
2021-04-02,228,8,67,1,735,78,10122,1596,2797,6219,250,47064,236,68,3281,79,10011
2021-04-03,164,2,46,0,745,78,10168,1499,2810,6243,256,47194,166,46,3283,79,10057
2021-04-04,204,5,54,0,759,78,10223,1513,2814,6256,281,47360,209,54,3288,79,10111
2021-04-05,221,6,53,0,770,78,10276,1583,2822,6265,304,47551,227,53,3294,79,10164
2021-04-06,275,6,55,0,785,78,10331,1690,2835,6305,299,47803,281,55,3300,79,10219
2021-04-07,243,9,62,1,801,78,10394,1684,2847,6343,292,48009,252,63,3309,80,10281
2021-04-08,239,9,48,0,806,78,10442,1648,2862,6398,274,48215,248,48,3318,80,10329
2021-04-09,291,7,55,0,810,78,10497,1669,2876,6430,288,48475,298,55,3325,80,10384
2021-04-10,206,2,51,0,800,78,10549,1579,2888,6448,311,48651,208,51,3327,80,10435
2021-04-11,197,6,58,0,804,78,10607,1592,2903,6456,333,48816,203,58,3333,80,10493
2021-04-12,235,10,48,0,807,78,10656,1665,2919,6497,330,49016,245,48,3343,80,10541
2021-04-13,219,5,44,0,795,78,10700,1611,2932,6540,319,49202,224,44,3348,80,10585
2021-04-14,244,5,54,0,802,77,10754,1583,2947,6585,307,49410,249,54,3353,80,10639
2021-04-15,236,9,64,0,819,77,10818,1562,2965,6619,311,49614,245,64,3362,80,10703
2021-04-16,253,6,52,0,812,77,10871,1598,2977,6674,288,49840,259,52,3368,80,10755
2021-04-17,205,5,54,0,821,77,10925,1518,2990,6691,314,50005,210,54,3373,80,10809
2021-04-18,210,4,54,0,820,77,10979,1547,2998,6698,340,50173,214,54,3377,80,10863
2021-04-19,334,4,64,0,846,78,11043,1744,3013,6739,348,50462,338,64,3381,80,10927
2021-04-20,276,9,52,0,834,77,11095,1751,3024,6789,328,50703,285,52,3390,80,10979
2021-04-21,275,4,51,0,842,77,11146,1752,3037,6827,320,50939,279,51,3394,80,11030
2021-04-22,228,6,45,0,843,77,11191,1750,3050,6877,310,51136,234,45,3400,80,11075
2021-04-23,252,14,64,0,858,77,11255,1722,3068,6928,307,51348,266,64,3414,80,11139
2021-04-24,199,4,51,0,842,76,11306,1603,3077,6941,330,51515,203,51,3418,80,11190
2021-04-25,221,4,43,0,839,77,11349,1630,3087,6959,358,51700,225,43,3422,80,11233
2021-04-26,333,6,60,0,842,77,11409,1803,3097,7016,347,51989,339,60,3428,80,11293
2021-04-27,182,6,52,0,839,77,11461,1712,3108,7040,361,52134,188,52,3434,80,11345
2021-04-28,326,5,48,0,836,77,11510,1835,3124,7084,360,52426,331,48,3439,80,11393
2021-04-29,283,3,66,0,843,77,11576,1869,3136,7129,359,52655,286,66,3442,80,11459
2021-04-30,250,6,51,0,839,77,11627,1848,3152,7180,347,52866,256,51,3448,80,11510
2021-05-01,180,0,38,0,823,77,11665,1724,3164,7198,351,53015,180,38,3448,80,11548
2021-05-02,181,4,67,0,854,78,11732,1674,3187,7213,370,53153,185,67,3452,80,11615
2021-05-03,276,6,52,0,851,78,11784,1778,3200,7263,359,53394,282,52,3458,80,11667
2021-05-04,226,4,51,0,851,77,11835,1721,3215,7318,344,53584,230,51,3462,80,11718
2021-05-05,194,3,43,1,837,78,11880,1598,3233,7338,368,53742,197,44,3465,81,11761
2021-05-06,215,5,45,0,821,78,11925,1619,3247,7381,368,53916,220,45,3470,81,11806
2021-05-07,232,3,46,0,809,78,11971,1629,3260,7436,354,54111,235,46,3473,81,11852
2021-05-08,150,4,38,0,790,77,12009,1510,3276,7451,369,54235,154,38,3477,81,11890
2021-05-09,163,3,36,0,780,77,12045,1481,3289,7465,394,54368,166,36,3480,81,11926
2021-05-10,246,3,36,0,763,78,12081,1575,3303,7512,384,54584,249,36,3483,81,11962
2021-05-11,190,3,41,0,752,78,12122,1515,3311,7576,358,54738,193,41,3486,81,12003
2021-05-12,172,4,37,0,741,78,12160,1439,3323,7627,334,54887,176,37,3490,81,12040
2021-05-13,149,2,27,0,726,78,12187,1326,3328,7643,345,55015,151,27,3492,81,12067
2021-05-14,208,2,32,0,725,78,12219,1393,3344,7692,334,55193,210,32,3494,81,12099
2021-05-15,139,3,33,0,708,78,12252,1277,3355,7707,355,55307,142,33,3497,81,12132
2021-05-16,128,5,25,0,687,78,12277,1250,3362,7717,378,55417,133,25,3502,81,12157
2021-05-17,189,6,37,0,686,78,12314,1338,3375,7767,372,55578,195,37,3508,81,12194
2021-05-18,153,5,33,0,661,78,12347,1291,3388,7823,346,55705,158,33,3513,81,12227
2021-05-19,136,6,23,0,640,77,12370,1199,3395,7872,324,55819,142,23,3519,81,12250
2021-05-20,150,9,23,0,627,77,12393,1159,3409,7914,308,55954,159,23,3528,81,12273
2021-05-21,139,2,23,0,611,77,12416,1118,3413,7968,275,56068,141,23,3530,81,12296
2021-05-22,89,4,26,0,608,77,12442,1006,3422,7983,280,56139,93,26,3534,81,12322
2021-05-23,81,5,21,0,600,76,12463,971,3429,7990,296,56210,86,21,3539,81,12343
2021-05-24,99,2,30,0,600,77,12493,966,3434,7998,313,56277,101,30,3541,81,12373
2021-05-25,120,3,17,0,587,77,12510,993,3444,8040,299,56376,123,17,3544,81,12390
2021-05-26,80,2,13,0,561,77,12523,924,3448,8085,279,56442,82,13,3546,81,12403
2021-05-27,89,4,18,0,547,77,12541,855,3454,8116,277,56512,93,18,3550,81,12421
2021-05-28,89,1,16,0,527,77,12557,816,3465,8161,251,56587,90,16,3551,81,12437
2021-05-29,56,3,10,1,507,76,12568,728,3472,8172,259,56632,59,11,3554,82,12447
2021-05-30,54,5,12,0,493,76,12580,701,3477,8178,277,56681,59,12,3559,82,12459
2021-05-31,84,7,9,0,474,76,12589,731,3486,8215,262,56757,91,9,3566,82,12468
2021-06-01,67,4,7,0,449,76,12596,680,3496,8251,250,56817,71,7,3570,82,12475
2021-06-02,63,5,13,0,427,77,12609,636,3502,8286,245,56870,68,13,3575,82,12488
2021-06-03,55,3,6,0,398,76,12615,598,3509,8309,246,56918,58,6,3578,82,12494
2021-06-04,79,5,5,0,372,76,12620,603,3517,8341,228,56995,84,5,3583,82,12499
2021-06-05,42,5,7,0,357,75,12627,562,3523,8348,230,57033,47,7,3588,82,12506
2021-06-06,43,6,5,0,347,75,12632,555,3527,8353,232,57075,49,5,3594,82,12511
2021-06-07,48,5,5,0,343,74,12637,565,3534,8391,212,57117,53,5,3599,82,12516
2021-06-08,52,1,8,0,325,75,12645,532,3542,8428,188,57162,53,8,3600,82,12524
2021-06-09,39,2,9,0,313,74,12654,477,3544,8458,172,57195,41,9,3602,82,12533
2021-06-10,39,0,4,0,301,73,12658,447,3550,8482,163,57226,39,4,3602,82,12537
2021-06-11,34,0,6,0,285,73,12664,420,3554,8500,161,57252,34,6,3602,82,12543
2021-06-12,22,3,7,0,272,73,12671,371,3555,8501,167,57274,25,7,3605,82,12550
2021-06-13,22,3,2,0,267,73,12673,371,3555,8502,174,57296,25,2,3608,82,12552
2021-06-14,42,6,7,0,268,74,12680,395,3557,8513,179,57332,48,7,3614,82,12559
2021-06-15,24,5,4,0,254,73,12684,352,3559,8532,176,57355,29,4,3619,82,12563
2021-06-16,26,3,6,0,241,73,12690,331,3568,8551,163,57379,29,6,3622,82,12569
2021-06-17,27,2,5,0,230,73,12695,327,3572,8575,149,57403,29,5,3624,82,12574
2021-06-18,29,5,3,0,219,72,12698,321,3574,8587,149,57432,34,3,3629,82,12577
2021-06-19,12,2,5,0,208,71,12703,292,3576,8590,155,57442,14,5,3631,82,12582
2021-06-20,17,5,3,0,198,70,12706,289,3580,8592,156,57461,22,3,3636,82,12585
2021-06-21,15,3,5,0,196,70,12711,290,3581,8616,145,57477,18,5,3639,82,12590
2021-06-22,17,3,4,0,185,68,12715,264,3584,8631,141,57494,20,4,3642,82,12594
2021-06-23,16,5,2,0,173,66,12717,255,3587,8642,141,57514,21,2,3647,82,12596
2021-06-24,10,1,1,0,160,66,12718,234,3588,8662,129,57523,11,1,3648,82,12597
2021-06-25,16,2,3,0,152,64,12721,220,3591,8679,113,57537,18,3,3650,82,12600
2021-06-26,11,3,0,0,148,63,12721,208,3593,8684,113,57550,14,0,3653,82,12600
2021-06-27,8,2,3,0,143,62,12724,209,3596,8684,113,57558,10,3,3655,82,12603
2021-06-28,7,1,2,0,142,62,12726,202,3600,8698,107,57566,8,2,3656,82,12605
2021-06-29,10,2,0,0,131,61,12726,201,3601,8711,98,57577,12,0,3658,82,12605
2021-06-30,4,6,1,0,126,59,12727,187,3603,8720,97,57585,10,1,3664,82,12606
2021-07-01,10,4,0,0,115,55,12727,189,3604,8737,86,57598,14,0,3668,82,12606
2021-07-02,8,2,4,0,112,54,12731,180,3604,8747,77,57606,10,4,3670,82,12610
2021-07-03,4,1,1,0,112,53,12732,174,3605,8748,77,57611,5,1,3671,82,12611
2021-07-04,11,0,1,1,112,52,12734,178,3605,8750,76,57621,11,2,3671,83,12612
2021-07-05,9,2,1,0,111,52,12735,181,3606,8760,71,57630,11,1,3673,83,12613
2021-07-06,4,3,1,0,106,52,12736,172,3610,8773,62,57636,7,1,3676,83,12614
2021-07-07,11,2,0,0,98,52,12736,171,3611,8778,63,57649,13,0,3678,83,12614
2021-07-08,17,1,0,0,90,49,12736,178,3612,8784,59,57666,18,0,3679,83,12614
2021-07-09,13,2,3,0,89,49,12739,180,3614,8785,60,57681,15,3,3681,83,12617
2021-07-10,16,1,2,0,86,47,12741,186,3615,8786,62,57698,17,2,3682,83,12619
2021-07-11,17,3,5,0,87,45,12746,197,3615,8786,63,57715,20,5,3685,83,12624
2021-07-12,22,5,3,0,90,47,12749,212,3615,8793,64,57738,27,3,3690,83,12627
2021-07-13,24,5,5,0,86,45,12754,220,3615,8796,65,57762,29,5,3695,83,12632
2021-07-14,33,7,2,0,83,45,12756,243,3616,8802,63,57800,40,2,3702,83,12634
2021-07-15,42,4,5,0,83,44,12761,264,3616,8809,61,57844,46,5,3706,83,12639
2021-07-16,47,3,9,0,87,48,12770,288,3616,8812,60,57889,50,9,3709,83,12648
2021-07-17,43,0,4,0,88,46,12774,304,3616,8813,62,57927,43,4,3709,83,12652
2021-07-18,59,2,6,0,91,48,12780,345,3620,8814,62,57984,61,6,3711,83,12658
2021-07-19,87,3,23,0,109,54,12803,399,3621,8822,61,58062,90,23,3714,83,12681
2021-07-20,76,2,11,0,112,54,12814,435,3622,8831,57,58131,78,11,3716,83,12692
2021-07-21,74,2,15,0,120,55,12829,445,3624,8837,56,58196,76,15,3718,83,12707
2021-07-22,69,2,11,0,124,56,12840,458,3625,8845,53,58260,71,11,3720,83,12718
2021-07-23,94,3,15,0,132,56,12855,496,3627,8851,58,58347,97,15,3723,83,12733
2021-07-24,69,0,24,0,143,59,12879,505,3630,8855,58,58402,69,24,3723,83,12757
2021-07-25,75,2,16,0,152,62,12895,517,3630,8858,64,58465,77,16,3725,83,12773
2021-07-26,97,2,19,0,162,61,12914,575,3631,8867,65,58548,99,19,3727,83,12792
2021-07-27,81,6,22,1,173,68,12937,594,3632,8876,67,58618,87,23,3733,84,12814
2021-07-28,82,2,24,0,184,69,12961,594,3632,8885,68,58679,84,24,3735,84,12838
2021-07-29,80,2,14,0,188,70,12975,602,3633,8897,72,58748,82,14,3737,84,12852
2021-07-30,81,2,16,0,187,68,12991,606,3634,8904,74,58822,83,16,3739,84,12868
2021-07-31,64,0,17,0,194,69,13008,584,3635,8908,78,58881,64,17,3739,84,12885
2021-08-01,60,2,19,0,204,69,13027,598,3635,8912,82,58927,62,19,3741,84,12904
2021-08-02,76,3,18,0,214,69,13045,623,3636,8926,82,58990,79,18,3744,84,12922
2021-08-03,54,5,13,0,211,71,13058,579,3638,8945,73,59038,59,13,3749,84,12935
2021-08-04,63,3,20,0,218,72,13078,550,3639,8953,79,59092,66,20,3752,84,12955
2021-08-05,64,4,22,0,221,72,13100,535,3640,8959,84,59146,68,22,3756,84,12977
2021-08-06,59,3,13,0,222,72,13113,527,3641,8968,94,59195,62,13,3759,84,12990
2021-08-07,47,2,19,0,222,72,13132,511,3642,8969,107,59232,49,19,3761,84,13009
2021-08-08,48,1,16,0,221,71,13148,499,3645,8973,111,59269,49,16,3762,84,13025
2021-08-09,58,3,13,0,223,73,13161,510,3647,8985,108,59320,61,13,3765,84,13038
2021-08-10,59,2,14,0,225,74,13175,512,3652,9006,98,59370,61,14,3767,84,13052
2021-08-11,58,4,17,0,223,74,13192,494,3655,9019,99,59425,62,17,3771,84,13069
2021-08-12,69,3,10,0,218,74,13202,505,3660,9034,101,59489,72,10,3774,84,13079
2021-08-13,81,1,14,0,211,73,13216,523,3665,9046,98,59560,82,14,3775,84,13093
2021-08-14,50,3,12,0,209,73,13228,515,3666,9051,102,59610,53,12,3778,84,13105
2021-08-15,61,1,12,0,209,72,13240,533,3668,9053,108,59663,62,12,3779,84,13117
2021-08-16,76,4,11,0,210,70,13251,566,3669,9067,104,59737,80,11,3783,84,13128
2021-08-17,57,3,13,0,213,71,13264,551,3670,9086,93,59785,60,13,3786,84,13141
2021-08-18,55,0,19,0,224,73,13283,533,3672,9094,96,59824,55,19,3786,84,13160
2021-08-19,71,3,13,0,223,73,13296,530,3672,9112,91,59890,74,13,3789,84,13173
2021-08-20,48,0,15,0,225,72,13311,519,3676,9126,88,59927,48,15,3789,84,13188
2021-08-21,41,0,13,0,223,72,13324,484,3676,9131,89,59958,41,13,3789,84,13201
2021-08-22,60,1,11,0,227,72,13335,506,3679,9133,92,60013,61,11,3790,84,13212
2021-08-23,61,6,18,0,239,73,13353,538,3684,9143,95,60071,67,18,3796,84,13230
2021-08-24,54,3,13,0,235,73,13366,521,3688,9158,92,60119,57,13,3799,84,13243
2021-08-25,54,2,14,0,232,74,13380,506,3693,9170,92,60167,56,14,3801,84,13257
2021-08-26,63,4,16,0,228,74,13396,504,3695,9188,81,60222,67,16,3805,84,13273
2021-08-27,76,1,13,0,232,72,13409,506,3700,9202,75,60289,77,13,3806,84,13286
2021-08-28,52,0,13,0,233,72,13422,485,3705,9204,82,60331,52,13,3806,84,13299
2021-08-29,40,0,8,0,227,72,13430,494,3706,9206,88,60365,40,8,3806,84,13307
2021-08-30,66,3,11,0,228,73,13441,528,3708,9216,92,60427,69,11,3809,84,13318
2021-08-31,59,0,9,0,220,74,13450,504,3712,9229,92,60478,59,9,3809,84,13327
2021-09-01,66,2,13,0,214,74,13463,496,3717,9239,93,60537,68,13,3811,84,13340
2021-09-02,53,3,18,0,216,72,13481,495,3718,9252,89,60580,56,18,3814,84,13358
2021-09-03,71,3,16,0,221,72,13497,507,3721,9259,90,60641,74,16,3817,84,13374
2021-09-04,55,2,11,0,219,73,13508,487,3724,9264,93,60691,57,11,3819,84,13385
2021-09-05,33,2,13,0,222,72,13521,485,3726,9267,96,60718,35,13,3821,84,13398
2021-09-06,59,2,14,0,229,72,13535,504,3730,9281,90,60774,61,14,3823,84,13412
2021-09-07,56,1,15,0,231,73,13550,513,3732,9294,89,60818,57,15,3824,84,13427
2021-09-08,70,6,12,0,229,74,13562,517,3736,9301,94,60881,76,12,3830,84,13439
2021-09-09,50,2,14,0,225,74,13576,498,3742,9313,94,60922,52,14,3832,84,13453
2021-09-10,43,7,15,0,223,74,13591,491,3747,9331,82,60961,50,15,3839,84,13468
2021-09-11,45,3,6,0,216,73,13597,484,3750,9334,88,61005,48,6,3842,84,13474
2021-09-12,47,1,4,0,207,72,13601,494,3750,9335,91,61045,48,4,3843,84,13478
2021-09-13,55,3,4,0,207,71,13605,514,3752,9350,84,61094,58,4,3846,84,13482
2021-09-14,46,8,15,0,211,71,13620,500,3755,9362,84,61138,54,15,3854,84,13497
2021-09-15,46,3,16,0,211,73,13636,474,3757,9372,79,61173,49,16,3857,84,13513
2021-09-16,43,0,6,0,208,73,13642,466,3760,9384,76,61213,43,6,3857,84,13519
2021-09-17,45,4,8,0,204,70,13650,456,3761,9392,78,61254,49,8,3861,84,13527
2021-09-18,38,3,7,0,200,71,13657,432,3762,9392,83,61291,41,7,3864,84,13534
2021-09-19,29,1,11,0,205,71,13668,426,3763,9395,83,61315,30,11,3865,84,13545
2021-09-20,38,4,7,0,208,72,13675,442,3764,9409,82,61350,42,7,3869,84,13552
2021-09-21,25,3,13,0,207,72,13688,419,3766,9418,90,61367,28,13,3872,84,13565
2021-09-22,29,1,6,0,193,72,13694,396,3769,9423,92,61392,30,6,3873,84,13571
2021-09-23,40,6,11,0,194,73,13705,390,3769,9427,98,61432,46,11,3879,84,13582
2021-09-24,39,4,7,0,189,71,13712,378,3772,9440,97,61469,43,7,3883,84,13589
2021-09-25,34,0,8,0,183,72,13720,356,3773,9444,101,61496,34,8,3883,84,13597
2021-09-26,28,3,6,0,179,73,13726,363,3777,9446,106,61521,31,6,3886,84,13603
2021-09-27,45,2,3,0,171,73,13729,393,3780,9454,108,61563,47,3,3888,84,13606
2021-09-28,41,4,6,0,162,71,13735,391,3783,9460,111,61604,45,6,3892,84,13612
2021-09-29,31,1,7,0,155,70,13742,383,3786,9471,111,61629,32,7,3893,84,13619
2021-09-30,42,3,5,1,147,67,13748,394,3789,9484,106,61670,45,6,3896,85,13624
2021-10-01,48,3,8,0,146,68,13756,404,3791,9495,105,61715,51,8,3899,85,13632
2021-10-02,32,3,8,0,141,66,13764,382,3791,9498,108,61747,35,8,3902,85,13640
2021-10-03,33,0,8,0,143,66,13772,393,3793,9500,111,61774,33,8,3902,85,13648
2021-10-04,63,3,13,0,150,67,13785,436,3799,9513,109,61831,66,13,3905,85,13661
2021-10-05,43,2,6,0,139,65,13791,444,3804,9526,101,61871,45,6,3907,85,13667
2021-10-06,48,5,13,0,141,67,13804,456,3808,9533,101,61915,53,13,3912,85,13680
2021-10-07,38,1,6,0,136,66,13810,448,3811,9545,94,61950,39,6,3913,85,13686
2021-10-08,54,3,11,0,138,66,13821,458,3811,9560,87,61998,57,11,3916,85,13697
2021-10-09,38,4,12,1,145,67,13834,455,3814,9562,89,62033,42,13,3920,86,13709
2021-10-10,43,5,10,0,148,70,13844,475,3815,9562,94,62071,48,10,3925,86,13719
2021-10-11,67,5,12,0,154,71,13856,517,3819,9573,90,62134,72,12,3930,86,13731
2021-10-12,61,6,7,0,150,69,13863,547,3823,9587,79,62196,67,7,3936,86,13738
2021-10-13,61,4,12,0,155,69,13875,567,3826,9594,77,62255,65,12,3940,86,13750
2021-10-14,70,3,10,0,155,68,13885,581,3830,9602,82,62319,73,10,3943,86,13760
2021-10-15,71,5,11,0,149,65,13896,602,3834,9620,71,62389,76,11,3948,86,13771
2021-10-16,53,4,10,0,146,63,13906,598,3836,9622,74,62440,57,10,3952,86,13781
2021-10-17,60,3,17,0,157,64,13924,628,3838,9622,77,62490,63,17,3955,86,13798
2021-10-18,101,3,14,0,166,65,13938,688,3841,9640,70,62588,104,14,3958,86,13812
2021-10-19,92,7,18,0,169,65,13956,711,3845,9647,68,62675,99,18,3965,86,13830
2021-10-20,109,1,20,0,180,64,13976,746,3847,9650,71,62772,110,20,3966,86,13850
2021-10-21,107,2,13,0,184,69,13989,776,3849,9661,64,62871,109,13,3968,86,13863
2021-10-22,89,3,25,0,203,71,14014,791,3852,9674,59,62944,92,25,3971,86,13888
2021-10-23,81,4,7,0,199,71,14021,795,3856,9674,68,63023,85,7,3975,86,13895
2021-10-24,76,5,19,0,204,69,14040,824,3857,9677,72,63089,81,19,3980,86,13914
2021-10-25,119,6,15,0,213,71,14055,905,3860,9686,80,63206,125,15,3986,86,13929
2021-10-26,114,3,22,0,214,72,14077,928,3866,9697,75,63311,117,22,3989,86,13951
2021-10-27,146,5,21,0,223,71,14098,990,3872,9704,79,63450,151,21,3994,86,13972
2021-10-28,136,7,22,0,227,71,14120,1046,3873,9715,80,63580,143,22,4001,86,13994
2021-10-29,162,6,28,0,242,74,14148,1127,3879,9724,87,63734,168,28,4007,86,14022
2021-10-30,139,4,12,0,229,75,14160,1145,3883,9727,94,63868,143,12,4011,86,14034
2021-10-31,131,4,24,0,239,74,14184,1202,3886,9728,99,63992,135,24,4015,86,14058
2021-11-01,206,4,23,0,253,75,14207,1341,3892,9736,104,64189,210,23,4019,86,14081
2021-11-02,173,4,34,0,268,75,14241,1389,3898,9749,103,64347,177,34,4023,86,14115
2021-11-03,151,4,30,0,280,75,14271,1379,3904,9759,107,64482,155,30,4027,86,14145
2021-11-04,177,10,26,0,286,75,14297,1399,3908,9767,110,64648,187,26,4037,86,14171
2021-11-05,207,11,27,0,298,76,14324,1456,3913,9780,112,64848,218,27,4048,86,14198
2021-11-06,134,0,34,0,312,76,14358,1413,3918,9786,115,64961,134,34,4048,86,14232
2021-11-07,167,1,35,0,332,76,14393,1485,3926,9787,123,65104,168,35,4049,86,14267
2021-11-08,245,11,19,0,333,76,14412,1654,3933,9803,125,65339,256,19,4060,86,14286
2021-11-09,177,6,34,0,340,76,14446,1664,3940,9824,121,65502,183,34,4066,86,14320
2021-11-10,210,5,36,0,352,76,14482,1675,3943,9839,124,65694,215,36,4071,86,14356
2021-11-11,232,2,34,1,366,76,14517,1723,3953,9850,128,65906,234,35,4073,87,14390
2021-11-12,231,3,43,0,384,76,14561,1765,3965,9865,127,66118,234,43,4076,87,14433
2021-11-13,197,3,26,0,384,76,14587,1758,3971,9873,131,66300,200,26,4079,87,14459
2021-11-14,220,8,34,0,399,76,14621,1842,3980,9876,145,66500,228,34,4087,87,14493
2021-11-15,300,8,37,0,410,76,14658,2021,3984,9888,155,66781,308,37,4095,87,14530
2021-11-16,269,8,51,0,432,75,14709,2059,3988,9909,159,67021,277,51,4103,87,14581
2021-11-17,247,13,37,0,437,75,14746,2054,3999,9923,166,67255,260,37,4116,87,14618
2021-11-18,254,10,50,0,456,75,14796,2060,4008,9944,160,67487,264,50,4126,87,14668
2021-11-19,331,7,38,1,472,75,14835,2155,4021,9970,155,67795,338,39,4133,88,14706
2021-11-20,233,4,41,0,480,73,14876,2088,4032,9977,163,68007,237,41,4137,88,14747
2021-11-21,270,2,47,0,501,74,14923,2159,4041,9983,182,68242,272,47,4139,88,14794
2021-11-22,356,9,57,2,524,75,14982,2356,4045,10005,190,68563,365,59,4148,90,14851
2021-11-23,290,9,45,0,537,76,15028,2389,4057,10029,184,68822,299,45,4157,90,14896
2021-11-24,300,3,49,0,553,77,15077,2372,4070,10048,182,69079,303,49,4160,90,14945
2021-11-25,325,8,55,0,577,77,15132,2406,4088,10074,196,69370,333,55,4168,90,15000
2021-11-26,356,6,53,0,573,76,15185,2454,4098,10104,191,69686,362,53,4174,90,15053
2021-11-27,222,5,59,0,595,76,15244,2311,4107,10116,208,69871,227,59,4179,90,15112
2021-11-28,252,6,52,0,604,76,15297,2366,4120,10123,225,70091,258,52,4185,90,15164
2021-11-29,369,2,55,0,625,76,15352,2561,4130,10152,222,70430,371,55,4187,90,15219
2021-11-30,315,8,53,0,642,76,15405,2549,4152,10185,229,70713,323,53,4195,90,15272
2021-12-01,346,9,65,1,644,76,15471,2498,4169,10214,229,71005,355,66,4204,91,15337
2021-12-02,290,8,45,0,638,77,15517,2450,4180,10246,228,71255,298,45,4212,91,15382
2021-12-03,297,4,42,0,635,77,15559,2403,4196,10277,232,71523,301,42,4216,91,15424
2021-12-04,234,2,41,0,623,78,15600,2263,4208,10286,248,71726,236,41,4218,91,15465
2021-12-05,219,2,50,0,635,77,15650,2261,4212,10300,265,71915,221,50,4220,91,15515
2021-12-06,340,8,49,0,650,78,15699,2402,4221,10335,263,72218,348,49,4228,91,15564
2021-12-07,312,10,53,0,661,78,15752,2395,4232,10377,260,72501,322,53,4238,91,15617
2021-12-08,320,11,59,0,667,77,15811,2397,4244,10409,260,72782,331,59,4249,91,15676
2021-12-09,273,3,56,0,676,78,15867,2352,4259,10446,255,73017,276,56,4252,91,15732
2021-12-10,315,5,47,0,677,78,15914,2344,4273,10478,252,73307,320,47,4257,91,15779
2021-12-11,208,2,23,0,653,78,15937,2198,4279,10494,265,73493,210,23,4259,91,15802
2021-12-12,192,1,45,1,665,77,15982,2199,4292,10501,290,73654,193,46,4260,92,15847
2021-12-13,263,6,48,0,665,77,16030,2274,4302,10532,297,73876,269,48,4266,92,15895
2021-12-14,232,10,32,0,650,77,16063,2199,4309,10570,287,74087,242,32,4276,92,15927
2021-12-15,232,5,39,0,653,77,16102,2093,4319,10594,292,74284,237,39,4281,92,15966
2021-12-16,205,9,39,0,651,77,16141,2003,4330,10635,278,74462,214,39,4290,92,16005
2021-12-17,208,6,46,0,659,78,16187,1925,4342,10676,268,74635,214,46,4296,92,16051
2021-12-18,131,7,26,0,638,78,16213,1764,4351,10685,288,74756,138,26,4303,92,16077
2021-12-19,162,8,31,0,630,78,16244,1755,4362,10689,309,74895,170,31,4311,92,16108
2021-12-20,219,3,38,0,630,78,16282,1876,4377,10732,295,75093,222,38,4314,92,16146
2021-12-21,192,5,32,0,622,78,16314,1814,4390,10772,282,75262,197,32,4319,92,16178
2021-12-22,173,4,18,0,598,78,16332,1725,4397,10812,279,75419,177,18,4323,92,16196
2021-12-23,138,3,24,0,578,78,16356,1651,4411,10849,267,75540,141,24,4326,92,16220
2021-12-24,170,3,26,0,565,78,16382,1609,4425,10891,254,75687,173,26,4329,92,16246
2021-12-25,116,3,28,0,546,77,16410,1441,4433,10904,262,75784,119,28,4332,92,16274
2021-12-26,112,2,30,0,547,77,16440,1430,4441,10909,275,75882,114,30,4334,92,16304
2021-12-27,215,9,38,0,559,77,16478,1551,4453,10943,269,76074,224,38,4343,92,16342
2021-12-28,184,8,28,0,545,77,16506,1554,4471,10981,249,76250,192,28,4351,92,16370
2021-12-29,147,3,19,0,527,78,16525,1496,4485,11022,234,76381,150,19,4354,92,16389
2021-12-30,149,4,24,0,509,78,16549,1440,4495,11049,226,76515,153,24,4358,92,16413
2021-12-31,136,2,16,0,493,78,16565,1364,4508,11078,218,76635,138,16,4360,92,16429
2022-01-01,107,4,21,0,481,77,16586,1249,4518,11081,228,76734,111,21,4364,92,16450
2022-01-02,104,7,24,0,483,77,16610,1274,4528,11088,232,76827,111,24,4371,92,16474
2022-01-03,170,8,32,0,496,77,16642,1384,4540,11118,231,76978,178,32,4379,92,16506
2022-01-04,155,6,14,1,471,77,16657,1370,4551,11142,222,77130,161,15,4385,93,16520
2022-01-05,137,5,15,0,461,77,16672,1319,4561,11171,219,77252,142,15,4390,93,16535
2022-01-06,123,13,22,0,447,77,16694,1289,4568,11196,220,77371,136,22,4403,93,16557
2022-01-07,176,6,15,0,429,77,16709,1316,4572,11222,219,77537,182,15,4409,93,16572
2022-01-08,93,3,21,0,422,77,16730,1208,4579,11233,230,77615,96,21,4412,93,16593
2022-01-09,123,1,25,0,417,77,16755,1230,4588,11236,239,77721,124,25,4413,93,16618
2022-01-10,160,6,25,0,421,77,16780,1325,4594,11263,235,77860,166,25,4419,93,16643
2022-01-11,122,3,13,0,403,76,16793,1266,4599,11289,232,77963,125,13,4422,93,16656
2022-01-12,107,5,11,0,385,76,16804,1197,4604,11314,226,78066,112,11,4427,93,16667
2022-01-13,102,6,13,0,369,75,16817,1165,4616,11343,216,78157,108,13,4433,93,16680
2022-01-14,140,8,12,0,349,76,16830,1156,4626,11369,211,78292,148,12,4441,93,16692
2022-01-15,100,4,14,0,330,75,16844,1095,4631,11379,217,78382,104,14,4445,93,16706
2022-01-16,101,2,10,0,319,75,16854,1094,4633,11383,218,78473,103,10,4447,93,16716
2022-01-17,151,9,9,0,324,75,16863,1186,4637,11409,208,78619,160,9,4456,93,16725
2022-01-18,125,4,7,0,310,76,16870,1144,4641,11437,195,78738,129,7,4460,93,16732
2022-01-19,168,4,16,0,307,76,16886,1169,4651,11459,187,78893,172,16,4464,93,16748
2022-01-20,170,2,12,0,296,75,16898,1184,4654,11484,177,79056,172,12,4466,93,16760
2022-01-21,169,7,9,0,287,74,16907,1207,4658,11505,168,79212,176,9,4473,93,16769
2022-01-22,124,6,5,0,273,74,16912,1167,4661,11512,175,79328,130,5,4479,93,16774
2022-01-23,144,2,8,1,265,74,16921,1217,4666,11514,182,79464,146,9,4481,94,16782
2022-01-24,196,4,11,1,263,74,16933,1317,4668,11534,178,79650,200,12,4485,95,16793
2022-01-25,162,6,15,0,261,73,16948,1313,4673,11551,175,79798,168,15,4491,95,16808
2022-01-26,192,9,9,0,254,72,16957,1339,4681,11569,174,79982,201,9,4500,95,16817
2022-01-27,199,8,22,0,251,72,16979,1353,4686,11581,175,80174,207,22,4508,95,16839
2022-01-28,200,11,9,0,241,69,16989,1373,4692,11601,176,80369,211,9,4519,95,16848
2022-01-29,165,2,8,0,222,69,16997,1342,4701,11607,177,80525,167,8,4521,95,16856
2022-01-30,173,8,10,0,214,69,17008,1388,4703,11608,183,80691,181,10,4529,95,16866
2022-01-31,252,8,20,0,225,70,17028,1544,4707,11633,177,80935,260,20,4537,95,16886
2022-02-01,238,8,15,0,219,67,17043,1613,4711,11654,165,81165,246,15,4545,95,16901
2022-02-02,240,5,16,0,221,67,17059,1633,4718,11670,158,81389,245,16,4550,95,16917
2022-02-03,206,9,21,1,228,71,17081,1616,4720,11687,153,81585,215,22,4559,96,16938
2022-02-04,256,4,15,0,228,69,17096,1653,4725,11700,158,81817,260,15,4563,96,16953
2022-02-05,134,5,11,0,216,69,17107,1526,4731,11704,166,81947,139,11,4568,96,16964
2022-02-06,192,4,28,0,226,67,17135,1585,4732,11706,176,82120,196,28,4572,96,16992
2022-02-07,241,9,18,0,230,66,17153,1723,4736,11724,176,82343,250,18,4581,96,17010
2022-02-08,215,9,20,0,228,70,17173,1731,4739,11742,179,82546,224,20,4590,96,17030
2022-02-09,216,7,11,0,215,70,17184,1722,4742,11766,169,82756,223,11,4597,96,17041
2022-02-10,239,5,13,0,210,70,17197,1707,4748,11783,171,82983,244,13,4602,96,17054
2022-02-11,243,2,13,1,197,68,17211,1721,4755,11795,179,83210,245,14,4604,97,17067
2022-02-12,161,3,13,0,182,66,17224,1628,4760,11800,178,83365,164,13,4607,97,17080
2022-02-13,154,5,12,0,186,65,17236,1621,4765,11803,179,83507,159,12,4612,97,17092
2022-02-14,258,10,12,0,190,65,17248,1797,4766,11823,173,83752,268,12,4622,97,17104
2022-02-15,245,4,16,0,192,66,17264,1831,4771,11838,175,83972,249,16,4626,97,17120
2022-02-16,216,4,15,0,185,65,17280,1812,4774,11850,176,84177,220,15,4630,97,17135
2022-02-17,214,6,15,0,183,68,17296,1785,4778,11868,170,84382,220,15,4636,97,17150
2022-02-18,231,6,16,0,182,68,17312,1805,4782,11886,161,84598,237,16,4642,97,17166
2022-02-19,146,4,18,0,187,69,17330,1713,4789,11894,169,84728,150,18,4646,97,17184
2022-02-20,163,6,13,0,176,70,17343,1711,4793,11901,171,84880,169,13,4652,97,17197
2022-02-21,226,3,18,0,182,71,17361,1814,4794,11919,164,85085,229,18,4655,97,17215
2022-02-22,196,7,13,0,183,71,17374,1811,4797,11938,159,85269,203,13,4662,97,17228
2022-02-23,201,3,12,0,177,70,17386,1748,4799,11955,154,85453,204,12,4665,97,17240
2022-02-24,180,3,14,1,178,70,17401,1688,4803,11975,147,85614,183,15,4668,98,17254
2022-02-25,197,7,15,0,177,68,17416,1671,4806,11991,141,85798,204,15,4675,98,17269
2022-02-26,131,1,15,0,178,68,17431,1555,4807,11996,144,85915,132,15,4676,98,17284
2022-02-27,122,5,9,1,180,69,17441,1544,4809,11998,152,86028,127,10,4681,99,17293
2022-02-28,234,1,10,0,178,69,17451,1692,4812,12013,150,86241,235,10,4682,99,17303
2022-03-01,230,5,18,0,179,70,17469,1722,4816,12030,145,86452,235,18,4687,99,17321
2022-03-02,249,7,12,0,173,71,17481,1766,4819,12054,133,86683,256,12,4694,99,17333
2022-03-03,204,5,11,0,168,70,17492,1777,4825,12068,130,86880,209,11,4699,99,17344
2022-03-04,221,0,13,0,165,68,17505,1783,4828,12086,124,87082,221,13,4699,99,17357
2022-03-05,152,4,12,0,163,67,17517,1691,4831,12088,128,87228,156,12,4703,99,17369
2022-03-06,205,6,11,0,164,66,17528,1783,4836,12091,126,87425,211,11,4709,99,17380
2022-03-07,281,18,16,0,174,66,17544,1985,4841,12105,122,87706,299,16,4727,99,17396
2022-03-08,258,7,17,0,177,65,17561,2037,4844,12121,118,87949,265,17,4734,99,17413
2022-03-09,248,6,16,0,178,63,17577,2029,4849,12134,122,88184,254,16,4740,99,17429
2022-03-10,304,8,13,0,168,62,17590,2081,4854,12147,119,88482,312,13,4748,99,17442
2022-03-11,265,12,21,0,175,61,17611,2100,4862,12163,113,88742,277,21,4760,99,17463
2022-03-12,218,2,10,0,167,60,17622,2007,4866,12172,120,88945,220,10,4762,99,17473
2022-03-13,244,5,10,0,156,58,17632,2116,4871,12177,123,89186,249,10,4767,99,17483
2022-03-14,320,6,24,0,168,60,17656,2297,4878,12192,114,89484,326,24,4773,99,17507
2022-03-15,320,3,24,0,175,64,17680,2314,4881,12204,120,89784,323,24,4776,99,17531
2022-03-16,292,9,15,0,167,59,17695,2355,4888,12216,124,90063,301,15,4785,99,17546
2022-03-17,311,9,18,0,164,56,17713,2334,4895,12226,128,90356,320,18,4794,99,17564
2022-03-18,256,3,18,0,159,56,17731,2278,4897,12236,131,90593,259,18,4797,99,17582
2022-03-19,207,6,13,0,154,57,17744,2135,4904,12241,136,90795,213,13,4803,99,17595
2022-03-20,200,3,16,0,153,61,17760,2176,4910,12244,139,90985,203,16,4806,99,17611
2022-03-21,336,6,24,0,165,64,17784,2398,4916,12259,138,91295,342,24,4812,99,17635
2022-03-22,303,12,20,0,165,66,17804,2372,4922,12279,130,91583,315,20,4824,99,17655
2022-03-23,282,7,21,0,168,69,17825,2333,4929,12296,132,91848,289,21,4831,99,17676
2022-03-24,260,3,21,1,165,68,17847,2271,4932,12310,137,92084,263,22,4834,100,17697
2022-03-25,260,6,11,0,154,64,17858,2267,4937,12329,135,92329,266,11,4840,100,17708
2022-03-26,160,1,15,0,146,64,17873,2085,4942,12335,137,92472,161,15,4841,100,17723
2022-03-27,152,3,13,0,146,61,17886,2091,4943,12339,144,92612,155,13,4844,100,17736
2022-03-28,275,7,16,0,151,62,17902,2279,4947,12359,145,92873,282,16,4851,100,17752
2022-03-29,232,3,19,0,145,61,17921,2237,4951,12378,136,93077,235,19,4854,100,17771
2022-03-30,224,10,13,0,145,61,17934,2200,4955,12391,138,93291,234,13,4864,100,17784
2022-03-31,173,5,15,0,142,61,17949,2067,4960,12403,142,93448,178,15,4869,100,17799
2022-04-01,196,6,12,0,135,60,17961,2004,4962,12426,135,93635,202,12,4875,100,17811
2022-04-02,100,3,5,0,122,55,17966,1846,4967,12435,134,93728,103,5,4878,100,17816
2022-04-03,133,2,7,0,114,55,17973,1847,4969,12437,140,93855,135,7,4880,100,17823
2022-04-04,196,3,8,0,111,52,17981,1974,4970,12453,132,94036,199,8,4883,100,17831
2022-04-05,194,2,13,1,113,54,17995,1913,4976,12465,128,94210,196,14,4885,101,17844
2022-04-06,166,5,14,0,114,53,18009,1829,4981,12483,116,94368,171,14,4890,101,17858
2022-04-07,166,5,16,0,120,54,18025,1778,4987,12494,115,94525,171,16,4895,101,17874
2022-04-08,160,4,7,0,112,55,18032,1727,4993,12507,118,94674,164,7,4899,101,17881
2022-04-09,85,1,8,0,98,50,18040,1580,4994,12513,121,94751,86,8,4900,101,17889
2022-04-10,103,2,8,0,97,48,18048,1582,4997,12516,121,94848,105,8,4902,101,17897
2022-04-11,131,6,8,0,100,47,18056,1628,5001,12532,111,94970,137,8,4908,101,17905
2022-04-12,133,4,16,0,106,51,18072,1549,5004,12543,105,95091,137,16,4912,101,17921
2022-04-13,127,4,10,0,108,53,18082,1477,5006,12551,103,95211,131,10,4916,101,17931
2022-04-14,104,8,11,0,109,53,18093,1440,5007,12561,100,95303,112,11,4924,101,17942
2022-04-15,105,4,7,0,107,51,18100,1345,5011,12574,99,95398,109,7,4928,101,17949
2022-04-16,71,2,3,0,92,48,18103,1245,5013,12576,102,95465,73,3,4930,101,17952
2022-04-17,81,3,8,0,93,52,18111,1226,5016,12579,100,95541,84,8,4933,101,17960
2022-04-18,75,3,6,0,95,54,18117,1244,5019,12582,102,95605,78,6,4936,101,17966
2022-04-19,105,3,13,0,100,53,18130,1287,5023,12591,99,95697,108,13,4939,101,17979
2022-04-20,99,2,4,0,93,52,18134,1247,5025,12598,104,95787,101,4,4941,101,17983
2022-04-21,97,2,9,0,87,49,18143,1187,5026,12607,104,95872,99,9,4943,101,17992
2022-04-22,75,5,6,0,83,49,18149,1136,5028,12612,103,95941,80,6,4948,101,17998
2022-04-23,69,2,4,0,80,47,18153,1053,5031,12616,103,96007,71,4,4950,101,18002
2022-04-24,66,2,7,0,79,46,18160,1066,5035,12617,103,96067,68,7,4952,101,18009
2022-04-25,90,1,5,1,80,45,18166,1110,5036,12624,103,96151,91,6,4953,102,18014
2022-04-26,68,6,3,0,74,45,18169,1075,5038,12635,100,96217,74,3,4959,102,18017
2022-04-27,43,3,9,0,73,48,18178,982,5038,12640,101,96254,46,9,4962,102,18026
2022-04-28,70,3,3,0,70,46,18182,995,5040,12650,96,96319,73,3,4965,102,18029
2022-04-29,47,2,1,0,64,45,18183,945,5042,12657,93,96363,49,1,4967,102,18030
2022-04-30,42,3,6,0,65,42,18189,857,5044,12661,93,96404,45,6,4970,102,18036
2022-05-01,56,2,6,0,65,42,18195,868,5045,12661,95,96456,58,6,4972,102,18042
2022-05-02,62,2,3,0,65,41,18198,911,5047,12669,92,96516,64,3,4974,102,18045
2022-05-03,54,5,3,0,62,39,18201,893,5050,12678,93,96569,59,3,4979,102,18048
2022-05-04,65,2,8,0,54,39,18209,853,5052,12682,93,96631,67,8,4981,102,18056
2022-05-05,44,2,1,0,49,36,18210,801,5055,12684,94,96673,46,1,4983,102,18057
2022-05-06,40,0,3,0,46,36,18213,796,5056,12692,87,96709,40,3,4983,102,18060
2022-05-07,42,0,3,0,47,36,18216,742,5057,12693,88,96749,42,3,4983,102,18063
2022-05-08,42,3,3,0,48,34,18219,756,5058,12693,92,96783,45,3,4986,102,18066
2022-05-09,53,1,3,0,47,33,18222,780,5059,12704,88,96831,54,3,4987,102,18069
2022-05-10,48,4,6,0,46,31,18228,777,5060,12709,86,96879,52,6,4991,102,18075
2022-05-11,42,3,3,0,46,30,18231,733,5060,12718,78,96916,45,3,4994,102,18078
2022-05-12,43,3,1,0,46,30,18232,718,5064,12725,74,96956,46,1,4997,102,18079
2022-05-13,41,4,2,0,41,27,18234,688,5066,12734,69,96998,45,2,5001,102,18081
2022-05-14,17,2,2,0,36,25,18236,644,5067,12736,70,97015,19,2,5003,102,18083
2022-05-15,33,2,2,0,34,23,18238,651,5068,12736,70,97049,35,2,5005,102,18085
2022-05-16,59,6,6,0,40,27,18244,701,5068,12744,68,97102,65,6,5011,102,18091
2022-05-17,48,2,2,0,36,25,18246,692,5069,12750,64,97144,50,2,5013,102,18093
2022-05-18,42,3,4,0,36,26,18250,679,5074,12756,59,97181,45,4,5016,102,18097
2022-05-19,45,1,2,0,32,25,18252,661,5076,12759,59,97224,46,2,5017,102,18099
2022-05-20,33,3,1,0,29,23,18253,631,5077,12763,56,97254,36,1,5020,102,18100
2022-05-21,27,2,1,0,28,23,18254,593,5077,12763,57,97279,29,1,5022,102,18101
2022-05-22,21,2,2,1,29,23,18257,592,5078,12763,57,97302,23,3,5024,103,18103
2022-05-23,51,2,4,0,32,24,18261,630,5079,12767,56,97348,53,4,5026,103,18107
2022-05-24,44,2,3,0,31,24,18264,616,5081,12770,56,97384,46,3,5028,103,18110
2022-05-25,29,4,1,0,27,23,18265,591,5081,12774,55,97412,33,1,5032,103,18111
2022-05-26,20,1,2,0,26,22,18267,567,5082,12776,54,97431,21,2,5033,103,18113
2022-05-27,38,0,3,0,27,21,18270,581,5082,12782,50,97465,38,3,5033,103,18116
2022-05-28,19,1,0,0,26,20,18270,545,5082,12785,48,97484,20,0,5034,103,18116
2022-05-29,23,0,1,0,26,19,18271,545,5082,12785,48,97505,23,1,5034,103,18117
2022-05-30,46,5,0,1,27,19,18272,585,5082,12787,48,97551,51,1,5039,104,18117
2022-05-31,43,3,3,0,28,19,18275,584,5083,12790,46,97588,46,3,5042,104,18120
2022-06-01,35,3,5,0,31,23,18280,576,5085,12794,45,97620,38,5,5045,104,18125
2022-06-02,46,1,1,0,27,23,18281,586,5085,12798,44,97661,47,1,5046,104,18126
2022-06-03,48,4,1,0,25,20,18282,600,5088,12800,42,97706,52,1,5050,104,18127
2022-06-04,29,0,4,0,25,19,18286,582,5089,12801,42,97727,29,4,5050,104,18131
2022-06-05,35,0,3,0,25,19,18289,592,5090,12801,43,97758,35,3,5050,104,18134
2022-06-06,46,1,3,0,25,21,18292,618,5090,12801,45,97802,47,3,5051,104,18137
2022-06-07,50,6,1,0,25,21,18293,660,5090,12805,44,97854,56,1,5057,104,18138
2022-06-08,49,4,3,0,24,21,18296,654,5090,12808,42,97906,53,3,5061,104,18141
2022-06-09,63,1,7,0,30,25,18303,665,5090,12811,42,97964,64,7,5062,104,18148
2022-06-10,70,4,7,0,35,27,18310,697,5091,12813,43,98028,74,7,5066,104,18155
2022-06-11,49,2,2,0,33,25,18312,687,5092,12814,44,98074,51,2,5068,104,18157
2022-06-12,41,1,0,0,30,23,18312,699,5092,12814,45,98114,42,0,5069,104,18157
2022-06-13,62,4,5,0,34,26,18317,750,5092,12818,42,98174,66,5,5073,104,18162
2022-06-14,62,5,5,0,39,29,18322,760,5093,12820,44,98235,67,5,5078,104,18167
2022-06-15,73,5,4,0,38,28,18326,775,5095,12822,46,98308,78,4,5083,104,18171
2022-06-16,59,1,6,0,38,27,18332,781,5100,12822,51,98363,60,6,5084,104,18177
2022-06-17,83,5,4,0,32,23,18336,809,5101,12823,52,98448,88,4,5089,104,18181
2022-06-18,58,2,3,0,31,25,18339,786,5102,12824,53,98503,60,3,5091,104,18184
2022-06-19,81,3,2,0,30,24,18341,839,5104,12825,53,98583,84,2,5094,104,18186
2022-06-20,87,1,4,0,31,24,18345,898,5106,12828,53,98665,88,4,5095,104,18190
2022-06-21,77,3,8,0,34,27,18353,909,5106,12832,52,98741,80,8,5098,104,18198
2022-06-22,74,3,5,0,36,27,18358,912,5108,12838,48,98812,77,5,5101,104,18203
2022-06-23,102,0,7,0,39,29,18365,926,5108,12839,51,98908,102,7,5101,104,18210
2022-06-24,126,6,4,0,38,28,18369,969,5111,12842,50,99032,132,4,5107,104,18214
2022-06-25,86,0,6,0,40,28,18375,963,5112,12842,50,99112,86,6,5107,104,18220
2022-06-26,88,1,4,0,43,31,18379,1007,5112,12842,52,99194,89,4,5108,104,18224
2022-06-27,130,5,5,0,46,31,18384,1114,5112,12844,54,99325,135,5,5113,104,18229
2022-06-28,86,3,3,0,45,31,18387,1112,5113,12848,52,99409,89,3,5116,104,18232
2022-06-29,104,3,5,0,47,28,18392,1103,5115,12853,53,99507,107,5,5119,104,18237
2022-06-30,133,2,9,0,48,28,18401,1131,5115,12857,55,99631,135,9,5121,104,18246
2022-07-01,97,3,3,0,45,26,18404,1149,5116,12865,51,99727,100,3,5124,104,18249
2022-07-02,85,1,5,0,42,26,18409,1115,5117,12867,54,99811,86,5,5125,104,18254
2022-07-03,120,2,2,0,37,22,18411,1175,5118,12868,57,99929,122,2,5127,104,18256
2022-07-04,126,6,10,0,43,27,18421,1260,5120,12873,56,100048,132,10,5133,104,18266
2022-07-05,119,3,6,0,43,28,18427,1278,5121,12877,55,100158,122,6,5136,104,18272
2022-07-06,115,4,8,0,46,31,18435,1262,5122,12883,57,100265,119,8,5140,104,18280
2022-07-07,119,5,5,0,43,28,18440,1270,5126,12886,59,100381,124,5,5145,104,18285
2022-07-08,111,4,8,0,41,28,18448,1265,5127,12889,63,100485,115,8,5149,104,18293
2022-07-09,118,0,8,0,43,28,18456,1230,5129,12892,59,100594,118,8,5149,104,18301
2022-07-10,116,2,7,0,48,30,18463,1292,5129,12893,61,100706,118,7,5151,104,18308
2022-07-11,158,3,8,0,54,35,18471,1415,5129,12901,56,100855,161,8,5154,104,18316
2022-07-12,152,2,12,0,61,35,18483,1427,5132,12909,55,101001,154,12,5156,104,18328
2022-07-13,148,1,5,0,57,32,18488,1408,5134,12911,58,101143,149,5,5157,104,18333
2022-07-14,151,2,5,0,56,29,18493,1430,5135,12917,57,101284,153,5,5159,104,18338
2022-07-15,126,3,2,0,52,29,18495,1401,5137,12929,49,101409,129,2,5162,104,18340
2022-07-16,99,3,5,0,51,31,18500,1345,5137,12931,47,101505,102,5,5165,104,18345
2022-07-17,96,2,8,1,59,37,18509,1367,5138,12932,49,101598,98,9,5167,105,18353
2022-07-18,151,4,5,0,60,39,18514,1470,5143,12939,51,101741,155,5,5171,105,18358
2022-07-19,149,7,6,0,52,35,18520,1473,5144,12944,56,101887,156,6,5178,105,18364
2022-07-20,163,3,6,0,47,35,18526,1491,5145,12948,60,102040,166,6,5181,105,18370
2022-07-21,141,3,6,0,44,32,18532,1486,5145,12949,64,102174,144,6,5184,105,18376
2022-07-22,136,3,9,0,48,32,18541,1463,5146,12953,64,102303,139,9,5187,105,18385
2022-07-23,94,0,2,0,45,31,18543,1377,5148,12953,66,102381,94,2,5187,105,18387
2022-07-24,100,0,12,0,52,38,18555,1376,5149,12955,68,102473,100,12,5187,105,18399
2022-07-25,180,3,4,0,52,38,18559,1512,5149,12962,63,102643,183,4,5190,105,18403
2022-07-26,108,4,3,0,53,38,18562,1459,5151,12965,65,102750,112,3,5194,105,18406
2022-07-27,109,1,8,0,54,40,18570,1409,5153,12969,69,102850,110,8,5195,105,18414
2022-07-28,80,5,3,0,47,35,18573,1344,5154,12973,72,102926,85,3,5200,105,18417
2022-07-29,107,4,8,0,49,36,18581,1308,5154,12978,73,103022,111,8,5204,105,18425
2022-07-30,68,1,7,0,50,34,18588,1227,5156,12981,74,103090,69,7,5205,105,18432
2022-07-31,72,3,6,0,51,35,18594,1235,5156,12985,74,103158,75,6,5208,105,18438
2022-08-01,120,3,6,1,53,34,18601,1301,5157,12989,75,103266,123,7,5211,106,18444
2022-08-02,91,2,3,0,51,35,18604,1260,5157,12993,80,103348,93,3,5213,106,18447
2022-08-03,99,5,5,0,47,34,18609,1229,5160,13003,74,103442,104,5,5218,106,18452
2022-08-04,97,2,6,0,45,33,18615,1202,5162,13017,61,103531,99,6,5220,106,18458
2022-08-05,77,3,5,0,47,33,18620,1133,5163,13021,58,103604,80,5,5223,106,18463
2022-08-06,68,1,5,0,49,32,18625,1071,5167,13024,56,103667,69,5,5224,106,18468
2022-08-07,56,1,4,0,48,32,18629,1070,5168,13024,55,103719,57,4,5225,106,18472
2022-08-08,78,4,3,0,50,34,18632,1116,5169,13028,58,103796,82,3,5229,106,18475
2022-08-09,67,1,5,0,47,32,18637,1066,5170,13031,59,103851,68,5,5230,106,18480
2022-08-10,81,1,4,1,46,30,18642,1029,5172,13037,55,103925,82,5,5231,107,18484
2022-08-11,75,2,4,0,46,33,18646,1002,5174,13041,55,103993,77,4,5233,107,18488
2022-08-12,73,0,8,0,45,32,18654,988,5174,13047,59,104060,73,8,5233,107,18496
2022-08-13,53,1,6,0,42,31,18660,937,5175,13048,60,104108,54,6,5234,107,18502
2022-08-14,49,4,2,0,41,32,18662,949,5177,13050,59,104158,53,2,5238,107,18504
2022-08-15,84,1,8,0,46,37,18670,1009,5178,13056,55,104235,85,8,5239,107,18512
2022-08-16,71,2,2,0,44,36,18672,980,5178,13059,55,104300,73,2,5241,107,18514
2022-08-17,75,3,4,0,44,34,18677,971,5179,13060,56,104374,78,4,5244,107,18518
2022-08-18,63,2,5,0,45,34,18683,955,5181,13062,57,104433,65,5,5246,107,18523
2022-08-19,49,3,4,0,44,36,18687,905,5182,13070,55,104479,52,4,5249,107,18527
2022-08-20,44,2,4,0,41,33,18691,855,5183,13070,60,104522,46,4,5251,107,18531
2022-08-21,41,3,4,0,39,31,18696,870,5184,13071,60,104563,44,4,5254,107,18535
2022-08-22,66,0,4,1,42,31,18701,900,5186,13077,61,104621,66,5,5254,108,18539
2022-08-23,55,2,3,0,37,30,18704,882,5187,13084,58,104676,57,3,5256,108,18542
2022-08-24,53,2,2,0,34,28,18706,854,5188,13087,54,104725,55,2,5258,108,18544
2022-08-25,54,2,4,0,38,30,18710,831,5190,13091,54,104778,56,4,5260,108,18548
2022-08-26,53,2,0,1,33,27,18711,827,5191,13094,53,104825,55,1,5262,109,18548
2022-08-27,39,0,5,0,34,27,18716,773,5192,13095,54,104859,39,5,5262,109,18553
2022-08-28,37,1,3,0,34,27,18719,776,5192,13097,56,104894,38,3,5263,109,18556
2022-08-29,47,4,6,0,37,29,18725,806,5192,13104,54,104939,51,6,5267,109,18562
2022-08-30,45,2,3,0,34,28,18728,796,5194,13106,55,104983,47,3,5269,109,18565
2022-08-31,44,0,3,0,32,26,18731,775,5194,13109,56,105022,44,3,5269,109,18568
2022-09-01,50,1,3,0,31,25,18734,770,5194,13114,52,105069,51,3,5270,109,18571
2022-09-02,55,5,1,0,30,24,18735,765,5195,13115,54,105125,60,1,5275,109,18572
2022-09-03,34,1,5,0,31,24,18740,743,5195,13117,54,105155,35,5,5276,109,18577
2022-09-04,46,4,2,0,31,24,18742,769,5196,13119,56,105202,50,2,5280,109,18579
2022-09-05,62,2,3,0,29,22,18745,806,5197,13122,57,105259,64,3,5282,109,18582
2022-09-06,42,1,3,0,26,20,18748,782,5197,13127,55,105299,43,3,5283,109,18585
2022-09-07,57,3,4,0,28,20,18752,787,5198,13133,51,105355,60,4,5286,109,18589
2022-09-08,49,3,3,0,27,22,18755,771,5199,13135,49,105404,52,3,5289,109,18592
2022-09-09,67,1,1,0,27,22,18756,780,5199,13138,52,105469,68,1,5290,109,18593
2022-09-10,48,0,4,0,25,21,18760,780,5199,13140,51,105512,48,4,5290,109,18597
2022-09-11,44,1,5,0,30,23,18765,795,5199,13142,51,105553,45,5,5291,109,18602
2022-09-12,70,5,2,0,29,22,18767,845,5199,13146,49,105620,75,2,5296,109,18604
2022-09-13,67,0,3,0,31,24,18770,849,5199,13151,47,105684,67,3,5296,109,18607
2022-09-14,46,0,6,0,34,26,18776,819,5199,13154,49,105725,46,6,5296,109,18613
2022-09-15,55,3,1,0,30,23,18777,808,5199,13159,47,105778,58,1,5299,109,18614
2022-09-16,49,5,3,0,30,25,18780,792,5201,13162,47,105826,54,3,5304,109,18617
2022-09-17,55,3,4,0,28,25,18784,800,5202,13163,47,105881,58,4,5307,109,18621
2022-09-18,38,0,5,0,31,25,18789,801,5202,13165,47,105918,38,5,5307,109,18626
2022-09-19,68,1,6,0,36,28,18795,849,5204,13169,46,105984,69,6,5308,109,18632
2022-09-20,81,2,1,0,33,28,18796,874,5205,13171,49,106060,83,1,5310,109,18633
2022-09-21,72,1,5,1,31,26,18802,876,5206,13175,46,106128,73,6,5311,110,18638
2022-09-22,74,2,4,0,33,26,18806,900,5207,13177,46,106202,76,4,5313,110,18642
2022-09-23,93,4,3,0,33,25,18809,945,5208,13180,44,106294,97,3,5317,110,18645
2022-09-24,64,0,2,0,32,24,18811,924,5208,13181,44,106356,64,2,5317,110,18647
2022-09-25,88,0,10,0,39,26,18821,987,5208,13182,47,106437,88,10,5317,110,18657
2022-09-26,122,3,9,0,44,31,18830,1077,5208,13185,48,106553,125,9,5320,110,18666
2022-09-27,122,1,6,1,47,32,18837,1123,5209,13190,49,106670,123,7,5321,111,18672
2022-09-28,119,5,3,0,43,31,18841,1164,5210,13195,49,106786,124,3,5326,111,18675
2022-09-29,123,3,8,1,44,32,18850,1193,5211,13198,49,106903,126,9,5329,112,18683
2022-09-30,141,2,2,0,42,30,18852,1226,5213,13203,47,107040,143,2,5331,112,18685
2022-10-01,91,0,6,0,41,30,18858,1223,5214,13205,48,107124,91,6,5331,112,18691
2022-10-02,102,2,12,0,51,31,18870,1265,5215,13207,51,107222,104,12,5333,112,18703
2022-10-03,155,2,5,0,52,32,18875,1377,5216,13211,55,107369,157,5,5335,112,18708
2022-10-04,145,1,5,0,48,34,18880,1400,5216,13216,58,107509,146,5,5336,112,18713
2022-10-05,142,0,11,0,51,36,18891,1412,5218,13221,58,107643,142,11,5336,112,18724
2022-10-06,134,4,7,0,51,36,18898,1415,5221,13225,56,107774,138,7,5340,112,18731
2022-10-07,166,2,11,0,57,42,18909,1453,5222,13232,59,107932,168,11,5342,112,18742
2022-10-08,116,0,4,0,50,36,18913,1432,5222,13234,60,108044,116,4,5342,112,18746
2022-10-09,101,2,4,0,51,37,18917,1472,5224,13236,62,108143,103,4,5344,112,18750
2022-10-10,164,5,9,0,54,35,18926,1582,5225,13240,66,108299,169,9,5349,112,18759
2022-10-11,139,2,9,1,55,34,18936,1583,5227,13246,67,108431,141,10,5351,113,18768
2022-10-12,134,1,7,0,53,37,18943,1567,5232,13253,63,108559,135,7,5352,113,18775
2022-10-13,149,3,4,0,47,34,18947,1561,5235,13260,62,108704,152,4,5355,113,18779
2022-10-14,127,3,9,0,46,36,18956,1530,5238,13269,56,108830,130,9,5358,113,18788
2022-10-15,106,1,7,1,49,36,18964,1474,5238,13272,56,108930,107,8,5359,114,18795
2022-10-16,106,0,9,0,55,37,18973,1500,5242,13272,57,109028,106,9,5359,114,18804
2022-10-17,164,3,11,1,62,39,18985,1619,5243,13278,60,109187,167,12,5362,115,18815
2022-10-18,142,0,11,0,62,40,18996,1608,5245,13284,63,109317,142,11,5362,115,18826
2022-10-19,130,0,8,0,61,42,19004,1565,5248,13287,64,109440,130,8,5362,115,18834
2022-10-20,138,1,7,0,61,44,19011,1543,5248,13292,71,109564,139,7,5363,115,18841
2022-10-21,139,1,7,0,55,39,19018,1509,5254,13302,63,109696,140,7,5364,115,18848
2022-10-22,89,1,4,0,50,38,19022,1439,5258,13303,62,109777,90,4,5365,115,18852
2022-10-23,102,2,9,0,54,39,19031,1461,5260,13304,62,109874,104,9,5367,115,18861
2022-10-24,137,0,10,0,61,39,19041,1536,5263,13310,64,109997,137,10,5367,115,18871
2022-10-25,123,2,9,0,58,40,19051,1476,5267,13316,64,110113,125,9,5369,115,18880
2022-10-26,105,0,9,0,58,40,19060,1408,5270,13322,63,110207,105,9,5369,115,18889
2022-10-27,93,4,5,0,54,36,19065,1376,5274,13329,61,110299,97,5,5373,115,18894
2022-10-28,99,2,6,0,48,32,19071,1331,5275,13332,68,110387,101,6,5375,115,18900
2022-10-29,71,0,6,0,45,29,19077,1253,5276,13332,73,110449,71,6,5375,115,18906
2022-10-30,85,4,11,0,50,33,19088,1274,5278,13336,72,110528,89,11,5379,115,18917
2022-10-31,106,0,9,0,57,39,19097,1342,5279,13342,74,110620,106,9,5379,115,18926
2022-11-01,72,4,3,0,51,35,19100,1306,5280,13345,74,110685,76,3,5383,115,18929
2022-11-02,93,1,4,0,47,33,19104,1282,5282,13351,75,110771,94,4,5384,115,18933
2022-11-03,80,1,6,0,44,32,19110,1244,5282,13360,70,110844,81,6,5385,115,18939
2022-11-04,80,3,4,0,44,32,19114,1193,5283,13366,72,110918,83,4,5388,115,18943
2022-11-05,41,2,6,0,42,31,19121,1109,5286,13368,74,110955,43,6,5390,115,18949
2022-11-06,77,0,4,0,40,29,19125,1127,5290,13369,74,111024,77,4,5390,115,18953
2022-11-07,76,1,1,1,37,28,19127,1165,5290,13372,72,111091,77,2,5391,116,18954
2022-11-08,63,4,7,0,44,32,19134,1127,5293,13378,68,111143,67,7,5395,116,18961
2022-11-09,67,1,2,0,40,31,19136,1082,5294,13379,66,111205,68,2,5396,116,18963
2022-11-10,79,0,5,0,44,30,19141,1059,5294,13384,64,111273,79,5,5396,116,18968
2022-11-11,71,0,3,0,44,30,19144,1024,5295,13391,61,111338,71,3,5396,116,18971
2022-11-12,50,1,3,0,41,31,19147,972,5296,13391,65,111383,51,3,5397,116,18974
2022-11-13,42,1,3,0,39,32,19150,973,5297,13392,64,111424,43,3,5398,116,18977
2022-11-14,67,2,1,0,41,33,19151,1010,5299,13397,62,111490,69,1,5400,116,18978
2022-11-15,53,4,3,0,38,29,19154,999,5299,13400,65,111541,57,3,5404,116,18981
2022-11-16,69,2,3,0,35,29,19157,1005,5300,13401,69,111604,71,3,5406,116,18984
2022-11-17,68,2,3,0,31,27,19160,1007,5300,13407,63,111662,70,3,5408,116,18987
2022-11-18,56,2,2,0,32,26,19162,991,5300,13407,65,111712,58,2,5410,116,18989
2022-11-19,43,0,3,0,32,27,19165,943,5300,13408,66,111752,43,3,5410,116,18992
2022-11-20,29,1,4,0,36,28,19169,934,5300,13412,63,111777,30,4,5411,116,18996
2022-11-21,69,3,6,0,42,30,19175,984,5301,13417,63,111845,72,6,5414,116,19002
2022-11-22,74,4,5,0,41,29,19180,982,5304,13421,62,111916,78,5,5418,116,19007
2022-11-23,76,2,4,0,38,30,19184,974,5305,13422,66,111988,78,4,5420,116,19011
2022-11-24,59,1,5,1,38,30,19190,959,5306,13428,64,112040,60,6,5421,117,19016
2022-11-25,67,1,10,0,42,33,19200,953,5309,13435,60,112103,68,10,5422,117,19026
2022-11-26,47,0,4,0,39,28,19204,914,5312,13435,63,112145,47,4,5422,117,19030
2022-11-27,54,1,0,0,33,27,19204,936,5313,13436,66,112198,55,0,5423,117,19030
2022-11-28,73,3,3,0,33,26,19207,988,5313,13441,65,112263,76,3,5426,117,19033
2022-11-29,79,3,5,1,36,27,19213,1004,5313,13447,63,112337,82,6,5429,118,19038
2022-11-30,78,1,5,0,37,31,19218,1011,5314,13449,62,112411,79,5,5430,118,19043
2022-12-01,73,2,4,0,38,30,19222,1016,5316,13453,62,112480,75,4,5432,118,19047
2022-12-02,68,1,4,0,36,28,19226,1006,5316,13457,60,112541,69,4,5433,118,19051
2022-12-03,53,1,2,0,36,28,19228,972,5317,13459,63,112592,54,2,5434,118,19053
2022-12-04,55,3,5,0,36,30,19233,990,5317,13460,63,112644,58,5,5437,118,19058
2022-12-05,87,2,8,0,43,32,19241,1045,5318,13467,58,112726,89,8,5439,118,19066
2022-12-06,101,0,6,0,47,35,19247,1067,5318,13469,65,112821,101,6,5439,118,19072
2022-12-07,76,3,4,0,41,33,19251,1056,5319,13471,68,112896,79,4,5442,118,19076
2022-12-08,99,3,4,0,39,31,19255,1086,5320,13473,71,112987,102,4,5445,118,19080
2022-12-09,104,2,6,0,40,34,19261,1110,5323,13479,66,113087,106,6,5447,118,19086
2022-12-10,66,0,2,0,38,33,19263,1087,5325,13480,65,113147,66,2,5447,118,19088
2022-12-11,66,1,2,0,38,31,19265,1109,5326,13480,68,113208,67,2,5448,118,19090
2022-12-12,92,1,8,0,43,34,19273,1163,5328,13484,71,113293,93,8,5449,118,19098
2022-12-13,87,1,7,0,40,35,19280,1173,5329,13486,76,113371,88,7,5450,118,19105
2022-12-14,119,0,8,0,41,35,19288,1184,5335,13490,73,113479,119,8,5450,118,19113
2022-12-15,112,4,3,0,36,32,19291,1204,5336,13493,76,113580,116,3,5454,118,19116
2022-12-16,97,4,8,0,37,30,19299,1220,5337,13500,70,113671,101,8,5458,118,19124
2022-12-17,66,3,2,0,36,28,19301,1183,5338,13501,70,113733,69,2,5461,118,19126
2022-12-18,75,1,10,0,44,33,19311,1212,5338,13502,70,113797,76,10,5462,118,19136
2022-12-19,113,4,5,0,48,33,19316,1296,5340,13505,78,113905,117,5,5466,118,19141
2022-12-20,127,2,8,0,45,27,19324,1314,5341,13509,77,114024,129,8,5468,118,19149
2022-12-21,126,3,16,0,54,36,19340,1330,5342,13517,73,114132,129,16,5471,118,19165
2022-12-22,113,2,7,0,56,35,19347,1329,5343,13519,75,114235,115,7,5473,118,19172
2022-12-23,119,0,6,0,56,35,19353,1364,5346,13530,72,114342,119,6,5473,118,19178
2022-12-24,86,2,8,0,52,34,19361,1302,5347,13531,76,114423,88,8,5475,118,19186
2022-12-25,90,1,7,0,53,38,19368,1301,5348,13532,79,114506,91,7,5476,118,19193
2022-12-26,112,2,10,0,58,39,19378,1366,5351,13533,81,114615,114,10,5478,118,19203
2022-12-27,135,5,10,0,62,38,19388,1460,5351,13536,87,114744,140,10,5483,118,19213
2022-12-28,125,2,15,0,69,41,19403,1474,5351,13542,89,114861,127,15,5485,118,19228
2022-12-29,129,3,5,0,67,41,19408,1453,5353,13548,93,114988,132,5,5488,118,19233
2022-12-30,123,3,10,0,64,40,19418,1439,5353,13556,94,115109,126,10,5491,118,19243
2022-12-31,84,1,6,0,60,38,19424,1370,5356,13560,94,115180,85,6,5492,118,19249
2023-01-01,102,3,8,0,61,39,19432,1385,5357,13564,94,115278,105,8,5495,118,19257
2023-01-02,123,1,8,0,64,42,19440,1455,5358,13569,93,115385,124,8,5496,118,19265
2023-01-03,108,0,7,0,66,42,19447,1450,5361,13573,96,115480,108,7,5496,118,19272
2023-01-04,91,1,9,0,65,41,19456,1404,5365,13578,97,115567,92,9,5497,118,19281
2023-01-05,89,2,12,0,67,41,19468,1369,5369,13583,94,115648,91,12,5499,118,19293
2023-01-06,81,2,12,1,73,44,19481,1308,5373,13590,97,115723,83,13,5501,119,19305
2023-01-07,68,1,2,0,61,42,19483,1236,5376,13592,96,115786,69,2,5502,119,19307
2023-01-08,75,3,8,0,65,43,19491,1263,5379,13595,97,115858,78,8,5505,119,19315
2023-01-09,98,0,4,0,63,43,19495,1313,5381,13603,97,115943,98,4,5505,119,19319
2023-01-10,75,1,5,0,57,40,19500,1281,5384,13611,89,116007,76,5,5506,119,19324
2023-01-11,74,1,4,0,57,39,19504,1224,5385,13615,93,116072,75,4,5507,119,19328
2023-01-12,68,2,6,0,54,38,19510,1198,5386,13616,95,116131,70,6,5509,119,19334
2023-01-13,53,0,7,0,57,38,19517,1142,5386,13621,94,116178,53,7,5509,119,19341
2023-01-14,45,0,4,0,57,39,19521,1089,5388,13622,98,116213,45,4,5509,119,19345
2023-01-15,46,2,1,0,51,36,19522,1087,5388,13622,101,116257,48,1,5511,119,19346
2023-01-16,71,2,5,0,53,36,19527,1119,5389,13626,101,116317,73,5,5513,119,19351
2023-01-17,54,2,6,1,55,35,19534,1084,5392,13633,99,116367,56,7,5515,120,19357
2023-01-18,48,2,3,0,50,34,19537,1056,5393,13637,97,116413,50,3,5517,120,19360
2023-01-19,51,4,2,0,48,31,19539,1033,5394,13647,93,116463,55,2,5521,120,19362
2023-01-20,42,0,3,0,44,29,19542,995,5395,13652,91,116501,42,3,5521,120,19365
2023-01-21,28,1,0,0,40,28,19542,942,5397,13652,94,116529,29,0,5522,120,19365
2023-01-22,30,0,1,0,36,27,19543,947,5398,13652,94,116556,30,1,5522,120,19366
2023-01-23,50,1,7,0,42,33,19550,974,5398,13656,93,116598,51,7,5523,120,19373
2023-01-24,29,1,3,0,42,33,19553,929,5399,13657,96,116623,30,3,5524,120,19376
2023-01-25,28,1,2,1,38,30,19556,887,5400,13662,98,116649,29,3,5525,121,19378
2023-01-26,33,2,1,0,31,24,19557,882,5400,13664,100,116682,35,1,5527,121,19379
2023-01-27,44,3,2,0,29,22,19559,879,5400,13666,99,116721,47,2,5530,121,19381
2023-01-28,19,2,2,0,30,24,19561,840,5401,13668,98,116742,21,2,5532,121,19383
2023-01-29,30,3,3,1,32,26,19565,847,5401,13669,98,116774,33,4,5535,122,19386
2023-01-30,42,5,3,1,35,27,19569,879,5401,13672,98,116814,47,4,5540,123,19389
2023-01-31,15,4,2,1,35,26,19572,852,5401,13674,97,116833,19,3,5544,124,19391
2023-02-01,2,0,0,0,34,26,19572,825,5401,13674,97,116834,2,0,5544,124,19391
